TTTCAGGCCGAGGTTGATTCCCCC -> TTCAGGCCGAGGTTGATTCCCCCG
AGCATTGAAATGCTAGGACGTCTA -> GCATTGAAATGCTAGGACGTCTAT
AACCAGACTGGTACATCGGAAAGA -> ACCAGACTGGTACATCGGAAAGAT
CAGTCGATATCCATCTGGATGGCA -> AGTCGATATCCATCTGGATGGCAC
TGAGCAGTTAATAGAAGTACCCCC -> GAGCAGTTAATAGAAGTACCCCCT
TGGAATAAAAAAAAATAGCGGGAG -> GGAATAAAAAAAAATAGCGGGAGA
TCTCTTAAGGTGCGACGGGGACTA -> CTCTTAAGGTGCGACGGGGACTAC
ATGCATTTGATCGTCATAAGCCAT -> TGCATTTGATCGTCATAAGCCATC
AATACCGCACAATCTTATAATAGT -> ATACCGCACAATCTTATAATAGTC
AGAGGCCTCAACGTTCTGCCAGAT -> GAGGCCTCAACGTTCTGCCAGATC
GAACTTACATGAATTCGCGATAAT -> AACTTACATGAATTCGCGATAATA
ACCGGAACCAGACTGGTACATCGG -> CCGGAACCAGACTGGTACATCGGA
CGCGATAATAGTCAAATCGAGCAT -> GCGATAATAGTCAAATCGAGCATT
CAGAGGTACAGAACTTTGTTACCC -> AGAGGTACAGAACTTTGTTACCCG
TGGCACCTACGTACGAGACGCTGC -> GGCACCTACGTACGAGACGCTGCC
CTCCCCTCATAAGCCGCCTCAATC -> TCCCCTCATAAGCCGCCTCAATCC
AATCCTATTTAGTTCAATACATAC -> ATCCTATTTAGTTCAATACATACG
CCCTGTTTACTTCGTTCGGCAGCT -> CCTGTTTACTTCGTTCGGCAGCTG
CCTCACTTAGTCGACTGAGCGGGA -> CTCACTTAGTCGACTGAGCGGGAT
GCCCTGCGCTCTCACGAGACGTGT -> CCCTGCGCTCTCACGAGACGTGTG
CGGCTACGGTATAGTGCTCGGAAC -> GGCTACGGTATAGTGCTCGGAACT
TGGCCAGCGATGCAACAACTGCTA -> GGCCAGCGATGCAACAACTGCTAA
TCAGAGGCCGATCCGGAACTTACA -> CAGAGGCCGATCCGGAACTTACAT
CCGGAACCAGACTGGTACATCGGA -> CGGAACCAGACTGGTACATCGGAA
ATCTTATAATAGTCGCTTCTAATG -> TCTTATAATAGTCGCTTCTAATGG
TGAACCTCCCCTCATAAGCCGCCT -> GAACCTCCCCTCATAAGCCGCCTC
CGATAATAGTCAAATCGAGCATTG -> GATAATAGTCAAATCGAGCATTGA
CCGATGGCCCTCACAAGAACCGTT -> CGATGGCCCTCACAAGAACCGTTA
TTACATGAATTCGCGATAATAGTC -> TACATGAATTCGCGATAATAGTCA
AGGCAGCTACAGTTTACTTACCTC -> GGCAGCTACAGTTTACTTACCTCG
ATAACTGCTCTTTACCTTGGTGCC -> TAACTGCTCTTTACCTTGGTGCCC
GCCTCAATCCTTACTGATGTCCAT -> CCTCAATCCTTACTGATGTCCATG
TTGATCGTCATAAGCCATCAGAAT -> TGATCGTCATAAGCCATCAGAATC
GATCGTCATAAGCCATCAGAATCA -> ATCGTCATAAGCCATCAGAATCAG
GGTGTGAGCAGTTAATAGAAGTAC -> GTGTGAGCAGTTAATAGAAGTACC
ACCGATGGCCAGCGATGCAACAAC -> CCGATGGCCAGCGATGCAACAACT
GTACCTCATCCCGATGGCCCTCAC -> TACCTCATCCCGATGGCCCTCACA
CTAACACAGAGGTACAGAACTTTG -> TAACACAGAGGTACAGAACTTTGT
ACTTACATGAATTCGCGATAATAG -> CTTACATGAATTCGCGATAATAGT
GTTGGATGCGGCTGAAACTGAATG -> TTGGATGCGGCTGAAACTGAATGG
CCCTATTTGTTGTGACACAGGAAG -> CCTATTTGTTGTGACACAGGAAGC
GAGACTGCCGGAACTCGTTCCGAT -> AGACTGCCGGAACTCGTTCCGATC
AATGCTAGGACGTCTATCAGGAAG -> ATGCTAGGACGTCTATCAGGAAGT
ACTGAATGGTAACGGCTGACATCT -> CTGAATGGTAACGGCTGACATCTG
GGACTACGTCACGTAGTCACTTGA -> GACTACGTCACGTAGTCACTTGAT
TTCATTCTAACACAGAGGTACAGA -> TCATTCTAACACAGAGGTACAGAA
TCCCCTCATAAGCCGCCTCAATCC -> CCCCTCATAAGCCGCCTCAATCCT
CGCTTCTAATGGGCTCTGGATAGT -> GCTTCTAATGGGCTCTGGATAGTG
CTCATAAGCCGCCTCAATCCTTAC -> TCATAAGCCGCCTCAATCCTTACT
CTTGACTCAACCGGAACCAGACTG -> TTGACTCAACCGGAACCAGACTGG
TACTGATAGATAATGGTCTCAGAC -> ACTGATAGATAATGGTCTCAGACA
TCGATATCCATCTGGATGGCACCT -> CGATATCCATCTGGATGGCACCTA
GTACCCCCTCCTTCGTAGTGGGCG -> TACCCCCTCCTTCGTAGTGGGCGA
GGGTGGTCGCCGATGACTTCGCCA -> GGTGGTCGCCGATGACTTCGCCAC
GAATAAAAAAAAATAGCGGGAGAT -> AATAAAAAAAAATAGCGGGAGATG
ACGAGACGCTGCCCTGCGCTCTCA -> CGAGACGCTGCCCTGCGCTCTCAC
ACCGAAAGTCAAGAATGTAATGGC -> CCGAAAGTCAAGAATGTAATGGCC
AATAGCGGGAGATGAATAGGGGAC -> ATAGCGGGAGATGAATAGGGGACA
AACGCTTACCAACTCAATCTAGGC -> ACGCTTACCAACTCAATCTAGGCG
CAGATCTTGATGCATAGAAATGAC -> AGATCTTGATGCATAGAAATGACC
CAGATCGCCTCACTTAGTCGACTG -> AGATCGCCTCACTTAGTCGACTGA
AATTACTGATAGATAATGGTCTCA -> ATTACTGATAGATAATGGTCTCAG
GTTGGGAACGATACTCAGTTGGAT -> TTGGGAACGATACTCAGTTGGATG
CCTACGTACGAGACGCTGCCCTGC -> CTACGTACGAGACGCTGCCCTGCG
ATCAATGTTAATGCATGGAATAAA -> TCAATGTTAATGCATGGAATAAAA
TCGATAGTTGTTTCCGCAAGGCAG -> CGATAGTTGTTTCCGCAAGGCAGC
AAGCCGCCTCAATCCTTACTGATG -> AGCCGCCTCAATCCTTACTGATGT
CGCTCTTTTCGAGGGGCACCGTTA -> GCTCTTTTCGAGGGGCACCGTTAA
GTCCATGTCCGAGGCACCCCGGAT -> TCCATGTCCGAGGCACCCCGGATT
GATTCAATAAAGCCCAGCTTGCCC -> ATTCAATAAAGCCCAGCTTGCCCT
ACCGAAGTGGTAAATTAAAGGCTT -> CCGAAGTGGTAAATTAAAGGCTTC
TGTGACACAGGAAGCAGCCAGATG -> GTGACACAGGAAGCAGCCAGATGC
CTGCCCTGCGCTCTCACGAGACGT -> TGCCCTGCGCTCTCACGAGACGTG
GTCGATAGTTGTTTCCGCAAGGCA -> TCGATAGTTGTTTCCGCAAGGCAG
ATGGTAACGGCTGACATCTGAACA -> TGGTAACGGCTGACATCTGAACAG
TTATAATAGTCGCTTCTAATGGGC -> TATAATAGTCGCTTCTAATGGGCT
TGAATAGGGGACAGTTGAAAGCGT -> GAATAGGGGACAGTTGAAAGCGTG
CTGGATAGTGTATTTCAGGCCGAG -> TGGATAGTGTATTTCAGGCCGAGG
ACGGGTGGTCACTCCTTATGTACC -> CGGGTGGTCACTCCTTATGTACCC
CTGAACAGTCGATATCCATCTGGA -> TGAACAGTCGATATCCATCTGGAT
GTGGCATAATACCGCACAATCTTA -> TGGCATAATACCGCACAATCTTAT
AGTACCGTGGGGCGTGACCGTACC -> GTACCGTGGGGCGTGACCGTACCG
TTTTTGTCGATAGTTGTTTCCGCA -> TTTTGTCGATAGTTGTTTCCGCAA
CGGAACCAGACTGGTACATCGGAA -> GGAACCAGACTGGTACATCGGAAA
GCTATGTGATTGTCTCGGCAGGAT -> CTATGTGATTGTCTCGGCAGGATG
ATCTCGGTATGAACCTCCCCTCAT -> TCTCGGTATGAACCTCCCCTCATA
CTTCGTTCGGCAGCTGACTCATCT -> TTCGTTCGGCAGCTGACTCATCTT
GGAGCGAGTCCTCTGTTCATTCTA -> GAGCGAGTCCTCTGTTCATTCTAA
GTTTACTTACCTCGACAGCTCGGG -> TTTACTTACCTCGACAGCTCGGGG
CGGGTGCGGATGAAATATGTCAGC -> GGGTGCGGATGAAATATGTCAGCA
ATCTGTCCGGGTGGTCGCCGATGA -> TCTGTCCGGGTGGTCGCCGATGAC
CTTACATGAATTCGCGATAATAGT -> TTACATGAATTCGCGATAATAGTC
GACAGTTGAAAGCGTGCGTTGGGA -> ACAGTTGAAAGCGTGCGTTGGGAA
TCTTATAATAGTCGCTTCTAATGG -> CTTATAATAGTCGCTTCTAATGGG
AATGCATGGAATAAAAAAAAATAG -> ATGCATGGAATAAAAAAAAATAGC
CAAACGGCTACGGTATAGTGCTCG -> AAACGGCTACGGTATAGTGCTCGG
TGTTACCCGACGTGCCTATAAAAT -> GTTACCCGACGTGCCTATAAAATT
TATGTACAAGTAACGGATGCTGGC -> ATGTACAAGTAACGGATGCTGGCC
AGAATGGAGGTTGCGGAGCGAGTC -> GAATGGAGGTTGCGGAGCGAGTCC
TGAAGAATGGAGGTTGCGGAGCGA -> GAAGAATGGAGGTTGCGGAGCGAG
ATATGTCAGCACCGCGTAGGCGCG -> TATGTCAGCACCGCGTAGGCGCGA
CCAGATGCATCTCGGTATGAACCT -> CAGATGCATCTCGGTATGAACCTC
AAATGCTAGGACGTCTATCAGGAA -> AATGCTAGGACGTCTATCAGGAAG
CTTACTGATGTCCATGTCCGAGGC -> TTACTGATGTCCATGTCCGAGGCA
GGCACTTCATCAATTCAGCGTTGT -> GCACTTCATCAATTCAGCGTTGTG
ACGTTCTGCCAGATCTTGATGCAT -> CGTTCTGCCAGATCTTGATGCATA
GACGTGCCTATAAAATTACTGATA -> ACGTGCCTATAAAATTACTGATAG
CTCGGCAGGATGAGGTTTGCCACA -> TCGGCAGGATGAGGTTTGCCACAC
GAATCAGCGTAGAGGCCTCAACGT -> AATCAGCGTAGAGGCCTCAACGTT
TATCCATCTGGATGGCACCTACGT -> ATCCATCTGGATGGCACCTACGTA
ACGGTATAGTGCTCGGAACTCTAT -> CGGTATAGTGCTCGGAACTCTATG
AATAGTCAAATCGAGCATTGAAAT -> ATAGTCAAATCGAGCATTGAAATG
CCCTCCTTCGTAGTGGGCGATGCT -> CCTCCTTCGTAGTGGGCGATGCTA
TGAGCGGGATATAGTACCGTGGGG -> GAGCGGGATATAGTACCGTGGGGC
CCGGCACTTCATCAATTCAGCGTT -> CGGCACTTCATCAATTCAGCGTTG
AGTCAAGAATGTAATGGCCTGCGT -> GTCAAGAATGTAATGGCCTGCGTC
AAAGCCCAGCTTGCCCTGTTTACT -> AAGCCCAGCTTGCCCTGTTTACTT
CCCGAAGGGGAACCTCAGGAAATT -> CCGAAGGGGAACCTCAGGAAATTT
AGACATATTGGACATTTCCTAATA -> GACATATTGGACATTTCCTAATAA
ATTTCAGGCCGAGGTTGATTCCCC -> TTTCAGGCCGAGGTTGATTCCCCC
CCCGACGTGCCTATAAAATTACTG -> CCGACGTGCCTATAAAATTACTGA
CCACACGAAACCGAAGTGGTAAAT -> CACACGAAACCGAAGTGGTAAATT
GAACGATACTCAGTTGGATGCGGC -> AACGATACTCAGTTGGATGCGGCT
AATGGTAACGGCTGACATCTGAAC -> ATGGTAACGGCTGACATCTGAACA
GTTCGGCAGCTGACTCATCTTGAA -> TTCGGCAGCTGACTCATCTTGAAT
GGTGCGACGGGGACTACGTCACGT -> GTGCGACGGGGACTACGTCACGTA
CCGCACCTGAAGCTATACAGGCGT -> CGCACCTGAAGCTATACAGGCGTA
CGGAGCGAGTCCTCTGTTCATTCT -> GGAGCGAGTCCTCTGTTCATTCTA
CGGATTCAATAAAGCCCAGCTTGC -> GGATTCAATAAAGCCCAGCTTGCC
TACGGTATAGTGCTCGGAACTCTA -> ACGGTATAGTGCTCGGAACTCTAT
GACGTCTATCAGGAAGTGTGCTGT -> ACGTCTATCAGGAAGTGTGCTGTC
AGGGTACCTCATCCCGATGGCCCT -> GGGTACCTCATCCCGATGGCCCTC
GTCATAAGCCATCAGAATCAGCGT -> TCATAAGCCATCAGAATCAGCGTA
TCCGGAACTTACATGAATTCGCGA -> CCGGAACTTACATGAATTCGCGAT
GCCACCTAGTCACCGGCACTTCAT -> CCACCTAGTCACCGGCACTTCATC
TGTCCGGGTGGTCGCCGATGACTT -> GTCCGGGTGGTCGCCGATGACTTC
TGTCTGTTCGAAGCGACGCTCTTT -> GTCTGTTCGAAGCGACGCTCTTTT
ATAAGCCATCAGAATCAGCGTAGA -> TAAGCCATCAGAATCAGCGTAGAG
TGATTGTCTCGGCAGGATGAGGTT -> GATTGTCTCGGCAGGATGAGGTTT
GGATGAGGTTTGCCACACGAAACC -> GATGAGGTTTGCCACACGAAACCG
CGTAGAGGCCTCAACGTTCTGCCA -> GTAGAGGCCTCAACGTTCTGCCAG
GATGACTTCGCCACCTAGTCACCG -> ATGACTTCGCCACCTAGTCACCGG
CCTGTTTACTTCGTTCGGCAGCTG -> CTGTTTACTTCGTTCGGCAGCTGA
TCCCCCGGACGGTAACCGATGGCC -> CCCCCGGACGGTAACCGATGGCCA
TGATCGTCATAAGCCATCAGAATC -> GATCGTCATAAGCCATCAGAATCA
ACATATTGGACATTTCCTAATAAC -> CATATTGGACATTTCCTAATAACT
TGACACAGGAAGCAGCCAGATGCA -> GACACAGGAAGCAGCCAGATGCAT
CGATCAATGTTAATGCATGGAATA -> GATCAATGTTAATGCATGGAATAA
ACTGAGCGGGATATAGTACCGTGG -> CTGAGCGGGATATAGTACCGTGGG
CTGTTTACTTCGTTCGGCAGCTGA -> TGTTTACTTCGTTCGGCAGCTGAC
TGCGTCAGAGGCAGTCCGGTTGAC -> GCGTCAGAGGCAGTCCGGTTGACA
ATCTTGATGCATAGAAATGACCCC -> TCTTGATGCATAGAAATGACCCCG
GGATGAAATATGTCAGCACCGCGT -> GATGAAATATGTCAGCACCGCGTA
CTCATCCCGATGGCCCTCACAAGA -> TCATCCCGATGGCCCTCACAAGAA
TGTTGTGACACAGGAAGCAGCCAG -> GTTGTGACACAGGAAGCAGCCAGA
GCACTTCATCAATTCAGCGTTGTG -> CACTTCATCAATTCAGCGTTGTGT
CATGAATTCGCGATAATAGTCAAA -> ATGAATTCGCGATAATAGTCAAAT
TAATAGAAGTACCCCCTCCTTCGT -> AATAGAAGTACCCCCTCCTTCGTA
ACGGCTGACATCTGAACAGTCGAT -> CGGCTGACATCTGAACAGTCGATA
GGGTATGGGTGAAGAATGGAGGTT -> GGTATGGGTGAAGAATGGAGGTTG
TGTCGATAGTTGTTTCCGCAAGGC -> GTCGATAGTTGTTTCCGCAAGGCA
AGCGACGCTCTTTTCGAGGGGCAC -> GCGACGCTCTTTTCGAGGGGCACC
TGCATGGAATAAAAAAAAATAGCG -> GCATGGAATAAAAAAAAATAGCGG
AGGCCGAGGTTGATTCCCCCGGAC -> GGCCGAGGTTGATTCCCCCGGACG
GTCGCCGATGACTTCGCCACCTAG -> TCGCCGATGACTTCGCCACCTAGT
TATTTCAGGCCGAGGTTGATTCCC -> ATTTCAGGCCGAGGTTGATTCCCC
GCACCCCGGATTCAATAAAGCCCA -> CACCCCGGATTCAATAAAGCCCAG
TCCCGAAGGGGAACCTCAGGAAAT -> CCCGAAGGGGAACCTCAGGAAATT
TGCCAGATCTTGATGCATAGAAAT -> GCCAGATCTTGATGCATAGAAATG
GAACTCGTTCCGATCTCTTAAGGT -> AACTCGTTCCGATCTCTTAAGGTG
TGCCCACTCCCCGCTTCAGATCGC -> GCCCACTCCCCGCTTCAGATCGCC
CACAAGAACCGTTATCTGTCCGGG -> ACAAGAACCGTTATCTGTCCGGGT
CGATGGCCAGCGATGCAACAACTG -> GATGGCCAGCGATGCAACAACTGC
GGTGAAGAATGGAGGTTGCGGAGC -> GTGAAGAATGGAGGTTGCGGAGCG
ATTGAAATGCTAGGACGTCTATCA -> TTGAAATGCTAGGACGTCTATCAG
TATCTGTCCGGGTGGTCGCCGATG -> ATCTGTCCGGGTGGTCGCCGATGA
CATACGGGTGGTCACTCCTTATGT -> ATACGGGTGGTCACTCCTTATGTA
CAGTTAATAGAAGTACCCCCTCCT -> AGTTAATAGAAGTACCCCCTCCTT
TTTGTTACCCGACGTGCCTATAAA -> TTGTTACCCGACGTGCCTATAAAA
CCCCGGATTCAATAAAGCCCAGCT -> CCCGGATTCAATAAAGCCCAGCTT
AGCCATCAGAATCAGCGTAGAGGC -> GCCATCAGAATCAGCGTAGAGGCC
AGGCGCGAGCGGAGACTGCCGGAA -> GGCGCGAGCGGAGACTGCCGGAAC
GCGACGGGGACTACGTCACGTAGT -> CGACGGGGACTACGTCACGTAGTC
AGTTCAATACATACGGGTGGTCAC -> GTTCAATACATACGGGTGGTCACT
GTCCGGGTGGTCGCCGATGACTTC -> TCCGGGTGGTCGCCGATGACTTCG
CTGAATGGTAACGGCTGACATCTG -> TGAATGGTAACGGCTGACATCTGA
GCCCAGCTTGCCCTGTTTACTTCG -> CCCAGCTTGCCCTGTTTACTTCGT
AACTTACATGAATTCGCGATAATA -> ACTTACATGAATTCGCGATAATAG
GCCGCCTCAATCCTTACTGATGTC -> CCGCCTCAATCCTTACTGATGTCC
CTCAGTTGGATGCGGCTGAAACTG -> TCAGTTGGATGCGGCTGAAACTGA
AACGAACGCTTACCAACTCAATCT -> ACGAACGCTTACCAACTCAATCTA
GGCGCGAGCGGAGACTGCCGGAAC -> GCGCGAGCGGAGACTGCCGGAACT
GATACTCAGTTGGATGCGGCTGAA -> ATACTCAGTTGGATGCGGCTGAAA
GTTGTGACACAGGAAGCAGCCAGA -> TTGTGACACAGGAAGCAGCCAGAT
GGTTGATTCCCCCGGACGGTAACC -> GTTGATTCCCCCGGACGGTAACCG
CCCCTCATAAGCCGCCTCAATCCT -> CCCTCATAAGCCGCCTCAATCCTT
CAGCTGACTCATCTTGAATCCTAT -> AGCTGACTCATCTTGAATCCTATT
TTCCTAATAACTGCTCTTTACCTT -> TCCTAATAACTGCTCTTTACCTTG
ACCTCGACAGCTCGGGGCAAGTGG -> CCTCGACAGCTCGGGGCAAGTGGC
GGAACTCGTTCCGATCTCTTAAGG -> GAACTCGTTCCGATCTCTTAAGGT
AGATGCATCTCGGTATGAACCTCC -> GATGCATCTCGGTATGAACCTCCC
TCCTTCGTAGTGGGCGATGCTATG -> CCTTCGTAGTGGGCGATGCTATGT
TGGTCTCAGACATATTGGACATTT -> GGTCTCAGACATATTGGACATTTC
AGGTTGATTCCCCCGGACGGTAAC -> GGTTGATTCCCCCGGACGGTAACC
CACACGAAACCGAAGTGGTAAATT -> ACACGAAACCGAAGTGGTAAATTA
AGACTGCCGGAACTCGTTCCGATC -> GACTGCCGGAACTCGTTCCGATCT
GACGGTAACCGATGGCCAGCGATG -> ACGGTAACCGATGGCCAGCGATGC
ATACTCAGTTGGATGCGGCTGAAA -> TACTCAGTTGGATGCGGCTGAAAC
CAGAGGCCGATCCGGAACTTACAT -> AGAGGCCGATCCGGAACTTACATG
TTCAATAAAGCCCAGCTTGCCCTG -> TCAATAAAGCCCAGCTTGCCCTGT
AACCGATGGCCAGCGATGCAACAA -> ACCGATGGCCAGCGATGCAACAAC
GGCCCTCACAAGAACCGTTATCTG -> GCCCTCACAAGAACCGTTATCTGT
CTTGCCCTGTTTACTTCGTTCGGC -> TTGCCCTGTTTACTTCGTTCGGCA
CTCATCTTGAATCCTATTTAGTTC -> TCATCTTGAATCCTATTTAGTTCA
GCGATGCTATGTGATTGTCTCGGC -> CGATGCTATGTGATTGTCTCGGCA
GAGTCCTCTGTTCATTCTAACACA -> AGTCCTCTGTTCATTCTAACACAG
AAAAAAATAGCGGGAGATGAATAG -> AAAAAATAGCGGGAGATGAATAGG
TGGAGGTTGCGGAGCGAGTCCTCT -> GGAGGTTGCGGAGCGAGTCCTCTG
AGCGTGCGTTGGGAACGATACTCA -> GCGTGCGTTGGGAACGATACTCAG
GGCGTTACGTTCAGAGGCCGATCC -> GCGTTACGTTCAGAGGCCGATCCG
AGCCAGATGCATCTCGGTATGAAC -> GCCAGATGCATCTCGGTATGAACC
TATAGTGCTCGGAACTCTATGTAC -> ATAGTGCTCGGAACTCTATGTACA
CGTTCGGCAGCTGACTCATCTTGA -> GTTCGGCAGCTGACTCATCTTGAA
AAGCGACGCTCTTTTCGAGGGGCA -> AGCGACGCTCTTTTCGAGGGGCAC
CTTACCTCGACAGCTCGGGGCAAG -> TTACCTCGACAGCTCGGGGCAAGT
ATGGGCTCTGGATAGTGTATTTCA -> TGGGCTCTGGATAGTGTATTTCAG
AAGTAACGGATGCTGGCCGCCTAC -> AGTAACGGATGCTGGCCGCCTACC
TGCGCTCTCACGAGACGTGTGGTG -> GCGCTCTCACGAGACGTGTGGTGT
CTCACGAGACGTGTGGTGTGAGCA -> TCACGAGACGTGTGGTGTGAGCAG
AAATTACTGATAGATAATGGTCTC -> AATTACTGATAGATAATGGTCTCA
ATAGTTGTTTCCGCAAGGCAGCTA -> TAGTTGTTTCCGCAAGGCAGCTAC
GGATAGTGTATTTCAGGCCGAGGT -> GATAGTGTATTTCAGGCCGAGGTT
AACGGATGCTGGCCGCCTACCGGG -> ACGGATGCTGGCCGCCTACCGGGG
GCCTACCGGGGTATGGGTGAAGAA -> CCTACCGGGGTATGGGTGAAGAAT
GACAATGCATTTGATCGTCATAAG -> ACAATGCATTTGATCGTCATAAGC
TGGATAGTGTATTTCAGGCCGAGG -> GGATAGTGTATTTCAGGCCGAGGT
ACATTTCCTAATAACTGCTCTTTA -> CATTTCCTAATAACTGCTCTTTAC
TGTTTCCGCAAGGCAGCTACAGTT -> GTTTCCGCAAGGCAGCTACAGTTT
CGTGGGGCGTGACCGTACCGAAAG -> GTGGGGCGTGACCGTACCGAAAGT
ACTTCGTTCGGCAGCTGACTCATC -> CTTCGTTCGGCAGCTGACTCATCT
CTGCGCTCTCACGAGACGTGTGGT -> TGCGCTCTCACGAGACGTGTGGTG
GTGACACAGGAAGCAGCCAGATGC -> TGACACAGGAAGCAGCCAGATGCA
AGGCCTCAACGTTCTGCCAGATCT -> GGCCTCAACGTTCTGCCAGATCTT
AAAAATAGCGGGAGATGAATAGGG -> AAAATAGCGGGAGATGAATAGGGG
GCATAATACCGCACAATCTTATAA -> CATAATACCGCACAATCTTATAAT
TGCATAGAAATGACCCCGCACCTG -> GCATAGAAATGACCCCGCACCTGA
GCTCTGGATAGTGTATTTCAGGCC -> CTCTGGATAGTGTATTTCAGGCCG
ATATAGTACCGTGGGGCGTGACCG -> TATAGTACCGTGGGGCGTGACCGT
TTTTGTCGATAGTTGTTTCCGCAA -> TTTGTCGATAGTTGTTTCCGCAAG
GCAGTTAATAGAAGTACCCCCTCC -> CAGTTAATAGAAGTACCCCCTCCT
GCCAGATGCATCTCGGTATGAACC -> CCAGATGCATCTCGGTATGAACCT
CCTATTTAGTTCAATACATACGGG -> CTATTTAGTTCAATACATACGGGT
GGGGTATGGGTGAAGAATGGAGGT -> GGGTATGGGTGAAGAATGGAGGTT
GGCGATGCTATGTGATTGTCTCGG -> GCGATGCTATGTGATTGTCTCGGC
TCGCCACCTAGTCACCGGCACTTC -> CGCCACCTAGTCACCGGCACTTCA
CGGCAGGATGAGGTTTGCCACACG -> GGCAGGATGAGGTTTGCCACACGA
CTTCGCCACCTAGTCACCGGCACT -> TTCGCCACCTAGTCACCGGCACTT
TTAAGGTGCGACGGGGACTACGTC -> TAAGGTGCGACGGGGACTACGTCA
TCGGTATGAACCTCCCCTCATAAG -> CGGTATGAACCTCCCCTCATAAGC
TAATAACTGCTCTTTACCTTGGTG -> AATAACTGCTCTTTACCTTGGTGC
TAAGCCGCCTCAATCCTTACTGAT -> AAGCCGCCTCAATCCTTACTGATG
CGGTAACCGATGGCCAGCGATGCA -> GGTAACCGATGGCCAGCGATGCAA
GATCTTGATGCATAGAAATGACCC -> ATCTTGATGCATAGAAATGACCCC
ACGTACGAGACGCTGCCCTGCGCT -> CGTACGAGACGCTGCCCTGCGCTC
ATAGTCGCTTCTAATGGGCTCTGG -> TAGTCGCTTCTAATGGGCTCTGGA
CAGGAAATTTTTGTCTGTTCGAAG -> AGGAAATTTTTGTCTGTTCGAAGC
CGCACAATCTTATAATAGTCGCTT -> GCACAATCTTATAATAGTCGCTTC
CCGCAAGGCAGCTACAGTTTACTT -> CGCAAGGCAGCTACAGTTTACTTA
GCTGAAACTGAATGGTAACGGCTG -> CTGAAACTGAATGGTAACGGCTGA
CGGCTGACATCTGAACAGTCGATA -> GGCTGACATCTGAACAGTCGATAT
AAACCGAAGTGGTAAATTAAAGGC -> AACCGAAGTGGTAAATTAAAGGCT
CGACGGGGACTACGTCACGTAGTC -> GACGGGGACTACGTCACGTAGTCA
CAATAAAGCCCAGCTTGCCCTGTT -> AATAAAGCCCAGCTTGCCCTGTTT
CCTACCGGGGTATGGGTGAAGAAT -> CTACCGGGGTATGGGTGAAGAATG
AGAAGTACCCCCTCCTTCGTAGTG -> GAAGTACCCCCTCCTTCGTAGTGG
AGTCGATATCCATCTGGATGGCAC -> GTCGATATCCATCTGGATGGCACC
CTCTGGATAGTGTATTTCAGGCCG -> TCTGGATAGTGTATTTCAGGCCGA
ACATCGGAAAGATGAGGGTACCTC -> CATCGGAAAGATGAGGGTACCTCA
TAGAGGCCTCAACGTTCTGCCAGA -> AGAGGCCTCAACGTTCTGCCAGAT
GGTACATCGGAAAGATGAGGGTAC -> GTACATCGGAAAGATGAGGGTACC
TAGTTGTTTCCGCAAGGCAGCTAC -> AGTTGTTTCCGCAAGGCAGCTACA
CGAGTCCTCTGTTCATTCTAACAC -> GAGTCCTCTGTTCATTCTAACACA
ACCGTGGGGCGTGACCGTACCGAA -> CCGTGGGGCGTGACCGTACCGAAA
GGCTTCCCGAAGGGGAACCTCAGG -> GCTTCCCGAAGGGGAACCTCAGGA
CGCTTCAGATCGCCTCACTTAGTC -> GCTTCAGATCGCCTCACTTAGTCG
CGATCCGGAACTTACATGAATTCG -> GATCCGGAACTTACATGAATTCGC
TGACTCAACCGGAACCAGACTGGT -> GACTCAACCGGAACCAGACTGGTA
TCACGAGACGTGTGGTGTGAGCAG -> CACGAGACGTGTGGTGTGAGCAGT
CAGCGTTGTGTATGCATGACGGGT -> AGCGTTGTGTATGCATGACGGGTG
TTTCCTAATAACTGCTCTTTACCT -> TTCCTAATAACTGCTCTTTACCTT
TTTTGTCTGTTCGAAGCGACGCTC -> TTTGTCTGTTCGAAGCGACGCTCT
ACAGTTTACTTACCTCGACAGCTC -> CAGTTTACTTACCTCGACAGCTCG
GAGGTTGATTCCCCCGGACGGTAA -> AGGTTGATTCCCCCGGACGGTAAC
CTGAGCGGGATATAGTACCGTGGG -> TGAGCGGGATATAGTACCGTGGGG
AGGCGTATTAACTTGACTCAACCG -> GGCGTATTAACTTGACTCAACCGG
GATGCATCTCGGTATGAACCTCCC -> ATGCATCTCGGTATGAACCTCCCC
CCTCTGTTCATTCTAACACAGAGG -> CTCTGTTCATTCTAACACAGAGGT
GATGCGGCTGAAACTGAATGGTAA -> ATGCGGCTGAAACTGAATGGTAAC
CCGGAACTCGTTCCGATCTCTTAA -> CGGAACTCGTTCCGATCTCTTAAG
GAAATGCTAGGACGTCTATCAGGA -> AAATGCTAGGACGTCTATCAGGAA
GTCAGCACCGCGTAGGCGCGAGCG -> TCAGCACCGCGTAGGCGCGAGCGG
AACGGCTACGGTATAGTGCTCGGA -> ACGGCTACGGTATAGTGCTCGGAA
TGTCTCGGCAGGATGAGGTTTGCC -> GTCTCGGCAGGATGAGGTTTGCCA
CGTTGGGAACGATACTCAGTTGGA -> GTTGGGAACGATACTCAGTTGGAT
TCTTGAATCCTATTTAGTTCAATA -> CTTGAATCCTATTTAGTTCAATAC
TTGTGACACAGGAAGCAGCCAGAT -> TGTGACACAGGAAGCAGCCAGATG
ATGGAGGTTGCGGAGCGAGTCCTC -> TGGAGGTTGCGGAGCGAGTCCTCT
GGCAGGATGAGGTTTGCCACACGA -> GCAGGATGAGGTTTGCCACACGAA
ATGAATTCGCGATAATAGTCAAAT -> TGAATTCGCGATAATAGTCAAATC
AGCCGCCTCAATCCTTACTGATGT -> GCCGCCTCAATCCTTACTGATGTC
CAGACATATTGGACATTTCCTAAT -> AGACATATTGGACATTTCCTAATA
ATGGGTGAAGAATGGAGGTTGCGG -> TGGGTGAAGAATGGAGGTTGCGGA
GATAGTGTATTTCAGGCCGAGGTT -> ATAGTGTATTTCAGGCCGAGGTTG
TGTTAATGCATGGAATAAAAAAAA -> GTTAATGCATGGAATAAAAAAAAA
TTTTCGAGGGGCACCGTTAAGTTT -> TTTCGAGGGGCACCGTTAAGTTTT
CCTTATGTACCCACCTTGGTGCGC -> CTTATGTACCCACCTTGGTGCGCA
TCAATCCTTACTGATGTCCATGTC -> CAATCCTTACTGATGTCCATGTCC
GAAATGACCCCGCACCTGAAGCTA -> AAATGACCCCGCACCTGAAGCTAT
GTCCCTATTTGTTGTGACACAGGA -> TCCCTATTTGTTGTGACACAGGAA
CACCTAGTCACCGGCACTTCATCA -> ACCTAGTCACCGGCACTTCATCAA
TGGACATTTCCTAATAACTGCTCT -> GGACATTTCCTAATAACTGCTCTT
CCGTTAAGTTTTTGTCGATAGTTG -> CGTTAAGTTTTTGTCGATAGTTGT
GCTATACAGGCGTATTAACTTGAC -> CTATACAGGCGTATTAACTTGACT
CCCTGCGCTCTCACGAGACGTGTG -> CCTGCGCTCTCACGAGACGTGTGG
TATGAACCTCCCCTCATAAGCCGC -> ATGAACCTCCCCTCATAAGCCGCC
TATTAACTTGACTCAACCGGAACC -> ATTAACTTGACTCAACCGGAACCA
GTCCGAGGCACCCCGGATTCAATA -> TCCGAGGCACCCCGGATTCAATAA
TAAATTAAAGGCTTCCCGAAGGGG -> AAATTAAAGGCTTCCCGAAGGGGA
CGCACCTGAAGCTATACAGGCGTA -> GCACCTGAAGCTATACAGGCGTAT
TAGGCGTTACGTTCAGAGGCCGAT -> AGGCGTTACGTTCAGAGGCCGATC
GTAAATTAAAGGCTTCCCGAAGGG -> TAAATTAAAGGCTTCCCGAAGGGG
CAGTCCGGTTGACAATGCATTTGA -> AGTCCGGTTGACAATGCATTTGAT
GGTATAGTGCTCGGAACTCTATGT -> GTATAGTGCTCGGAACTCTATGTA
TCGGGGCAAGTGGCATAATACCGC -> CGGGGCAAGTGGCATAATACCGCA
AGTTGGATGCGGCTGAAACTGAAT -> GTTGGATGCGGCTGAAACTGAATG
TCCCGATGGCCCTCACAAGAACCG -> CCCGATGGCCCTCACAAGAACCGT
GTTTCCGCAAGGCAGCTACAGTTT -> TTTCCGCAAGGCAGCTACAGTTTA
GAAAGCGTGCGTTGGGAACGATAC -> AAAGCGTGCGTTGGGAACGATACT
TCCCCGCTTCAGATCGCCTCACTT -> CCCCGCTTCAGATCGCCTCACTTA
ATGTGATTGTCTCGGCAGGATGAG -> TGTGATTGTCTCGGCAGGATGAGG
CTTGATGCATAGAAATGACCCCGC -> TTGATGCATAGAAATGACCCCGCA
GTGTGAGCAGTTAATAGAAGTACC -> TGTGAGCAGTTAATAGAAGTACCC
GCTACGGTATAGTGCTCGGAACTC -> CTACGGTATAGTGCTCGGAACTCT
TTACGTTCAGAGGCCGATCCGGAA -> TACGTTCAGAGGCCGATCCGGAAC
GCCTATAAAATTACTGATAGATAA -> CCTATAAAATTACTGATAGATAAT
GGTAACCGATGGCCAGCGATGCAA -> GTAACCGATGGCCAGCGATGCAAC
GAACCTCCCCTCATAAGCCGCCTC -> AACCTCCCCTCATAAGCCGCCTCA
GGACGGTAACCGATGGCCAGCGAT -> GACGGTAACCGATGGCCAGCGATG
TAGTCAAATCGAGCATTGAAATGC -> AGTCAAATCGAGCATTGAAATGCT
AGAGGCCGATCCGGAACTTACATG -> GAGGCCGATCCGGAACTTACATGA
TGTCCATGTCCGAGGCACCCCGGA -> GTCCATGTCCGAGGCACCCCGGAT
GCGTTGGGAACGATACTCAGTTGG -> CGTTGGGAACGATACTCAGTTGGA
GCTTCTAATGGGCTCTGGATAGTG -> CTTCTAATGGGCTCTGGATAGTGT
GGAACCTCAGGAAATTTTTGTCTG -> GAACCTCAGGAAATTTTTGTCTGT
AGATCGCCTCACTTAGTCGACTGA -> GATCGCCTCACTTAGTCGACTGAG
CCCTCACAAGAACCGTTATCTGTC -> CCTCACAAGAACCGTTATCTGTCC
AACTTGACTCAACCGGAACCAGAC -> ACTTGACTCAACCGGAACCAGACT
ATAATAGTCAAATCGAGCATTGAA -> TAATAGTCAAATCGAGCATTGAAA
AGGAAGTGTGCTGTCCCTATTTGT -> GGAAGTGTGCTGTCCCTATTTGTT
CAGTTTACTTACCTCGACAGCTCG -> AGTTTACTTACCTCGACAGCTCGG
AAGGCAGCTACAGTTTACTTACCT -> AGGCAGCTACAGTTTACTTACCTC
TAGCGGGAGATGAATAGGGGACAG -> AGCGGGAGATGAATAGGGGACAGT
TGACTCATCTTGAATCCTATTTAG -> GACTCATCTTGAATCCTATTTAGT
TGTTCGAAGCGACGCTCTTTTCGA -> GTTCGAAGCGACGCTCTTTTCGAG
GGATGGCACCTACGTACGAGACGC -> GATGGCACCTACGTACGAGACGCT
TGACGGGTGCGGATGAAATATGTC -> GACGGGTGCGGATGAAATATGTCA
TTTGTCTGTTCGAAGCGACGCTCT -> TTGTCTGTTCGAAGCGACGCTCTT
GAAACCGAAGTGGTAAATTAAAGG -> AAACCGAAGTGGTAAATTAAAGGC
ATCCTTACTGATGTCCATGTCCGA -> TCCTTACTGATGTCCATGTCCGAG
TAGAAATGACCCCGCACCTGAAGC -> AGAAATGACCCCGCACCTGAAGCT
GCACAAACGGCTACGGTATAGTGC -> CACAAACGGCTACGGTATAGTGCT
CTCTGTTCATTCTAACACAGAGGT -> TCTGTTCATTCTAACACAGAGGTA
AGAATGTAATGGCCTGCGTCAGAG -> GAATGTAATGGCCTGCGTCAGAGG
CCACCTTGGTGCGCACAAACGGCT -> CACCTTGGTGCGCACAAACGGCTA
ATCGGAAAGATGAGGGTACCTCAT -> TCGGAAAGATGAGGGTACCTCATC
GGAACTCTATGTACAAGTAACGGA -> GAACTCTATGTACAAGTAACGGAT
GAGGCCGATCCGGAACTTACATGA -> AGGCCGATCCGGAACTTACATGAA
ACCTGAAGCTATACAGGCGTATTA -> CCTGAAGCTATACAGGCGTATTAA
CGCGTAGGCGCGAGCGGAGACTGC -> GCGTAGGCGCGAGCGGAGACTGCC
ATGGCACCTACGTACGAGACGCTG -> TGGCACCTACGTACGAGACGCTGC
TGGTAAATTAAAGGCTTCCCGAAG -> GGTAAATTAAAGGCTTCCCGAAGG
AAAGATGAGGGTACCTCATCCCGA -> AAGATGAGGGTACCTCATCCCGAT
AGGAAATTTTTGTCTGTTCGAAGC -> GGAAATTTTTGTCTGTTCGAAGCG
GCAACAACTGCTAACGAACGCTTA -> CAACAACTGCTAACGAACGCTTAC
CTGCTAACGAACGCTTACCAACTC -> TGCTAACGAACGCTTACCAACTCA
CGAGGTTGATTCCCCCGGACGGTA -> GAGGTTGATTCCCCCGGACGGTAA
CGATGGCCCTCACAAGAACCGTTA -> GATGGCCCTCACAAGAACCGTTAT
CATCTCGGTATGAACCTCCCCTCA -> ATCTCGGTATGAACCTCCCCTCAT
CGTCTATCAGGAAGTGTGCTGTCC -> GTCTATCAGGAAGTGTGCTGTCCC
ACAAGTAACGGATGCTGGCCGCCT -> CAAGTAACGGATGCTGGCCGCCTA
CTATAAAATTACTGATAGATAATG -> TATAAAATTACTGATAGATAATGG
TACGGGTGGTCACTCCTTATGTAC -> ACGGGTGGTCACTCCTTATGTACC
TTACTTACCTCGACAGCTCGGGGC -> TACTTACCTCGACAGCTCGGGGCA
GGAACCAGACTGGTACATCGGAAA -> GAACCAGACTGGTACATCGGAAAG
TAGTCGCTTCTAATGGGCTCTGGA -> AGTCGCTTCTAATGGGCTCTGGAT
CGGAGACTGCCGGAACTCGTTCCG -> GGAGACTGCCGGAACTCGTTCCGA
TGAAATATGTCAGCACCGCGTAGG -> GAAATATGTCAGCACCGCGTAGGC
CATAGAAATGACCCCGCACCTGAA -> ATAGAAATGACCCCGCACCTGAAG
ATCTTGAATCCTATTTAGTTCAAT -> TCTTGAATCCTATTTAGTTCAATA
ATTAACTTGACTCAACCGGAACCA -> TTAACTTGACTCAACCGGAACCAG
AATAAAAAAAAATAGCGGGAGATG -> ATAAAAAAAAATAGCGGGAGATGA
AGATGAGGGTACCTCATCCCGATG -> GATGAGGGTACCTCATCCCGATGG
CTCGGTATGAACCTCCCCTCATAA -> TCGGTATGAACCTCCCCTCATAAG
AAAAAAAAATAGCGGGAGATGAAT -> AAAAAAAATAGCGGGAGATGAATA
ATGGAATAAAAAAAAATAGCGGGA -> TGGAATAAAAAAAAATAGCGGGAG
CATTCTAACACAGAGGTACAGAAC -> ATTCTAACACAGAGGTACAGAACT
AATGTTAATGCATGGAATAAAAAA -> ATGTTAATGCATGGAATAAAAAAA
AATCCTTACTGATGTCCATGTCCG -> ATCCTTACTGATGTCCATGTCCGA
AACTGCTCTTTACCTTGGTGCCCA -> ACTGCTCTTTACCTTGGTGCCCAC
ACCGTTATCTGTCCGGGTGGTCGC -> CCGTTATCTGTCCGGGTGGTCGCC
CAGTTGGATGCGGCTGAAACTGAA -> AGTTGGATGCGGCTGAAACTGAAT
GCTTCCCGAAGGGGAACCTCAGGA -> CTTCCCGAAGGGGAACCTCAGGAA
GTGAGCAGTTAATAGAAGTACCCC -> TGAGCAGTTAATAGAAGTACCCCC
CAATGTTAATGCATGGAATAAAAA -> AATGTTAATGCATGGAATAAAAAA
CCGGATTCAATAAAGCCCAGCTTG -> CGGATTCAATAAAGCCCAGCTTGC
CAATCTTATAATAGTCGCTTCTAA -> AATCTTATAATAGTCGCTTCTAAT
TCTCAGACATATTGGACATTTCCT -> CTCAGACATATTGGACATTTCCTA
GAAGTGTGCTGTCCCTATTTGTTG -> AAGTGTGCTGTCCCTATTTGTTGT
GGACATTTCCTAATAACTGCTCTT -> GACATTTCCTAATAACTGCTCTTT
TGTCCGAGGCACCCCGGATTCAAT -> GTCCGAGGCACCCCGGATTCAATA
ACTTAGTCGACTGAGCGGGATATA -> CTTAGTCGACTGAGCGGGATATAG
GAGCGGAGACTGCCGGAACTCGTT -> AGCGGAGACTGCCGGAACTCGTTC
GGGAGATGAATAGGGGACAGTTGA -> GGAGATGAATAGGGGACAGTTGAA
CTGTTCATTCTAACACAGAGGTAC -> TGTTCATTCTAACACAGAGGTACA
GTTCATTCTAACACAGAGGTACAG -> TTCATTCTAACACAGAGGTACAGA
TTTACTTCGTTCGGCAGCTGACTC -> TTACTTCGTTCGGCAGCTGACTCA
TTCGTTCGGCAGCTGACTCATCTT -> TCGTTCGGCAGCTGACTCATCTTG
GATGCAACAACTGCTAACGAACGC -> ATGCAACAACTGCTAACGAACGCT
GAGCGGGATATAGTACCGTGGGGC -> AGCGGGATATAGTACCGTGGGGCG
CTCGTTCCGATCTCTTAAGGTGCG -> TCGTTCCGATCTCTTAAGGTGCGA
ATGGTCTCAGACATATTGGACATT -> TGGTCTCAGACATATTGGACATTT
CGATATCCATCTGGATGGCACCTA -> GATATCCATCTGGATGGCACCTAC
GGGACAGTTGAAAGCGTGCGTTGG -> GGACAGTTGAAAGCGTGCGTTGGG
AGTTGAAAGCGTGCGTTGGGAACG -> GTTGAAAGCGTGCGTTGGGAACGA
CTAGGCGTTACGTTCAGAGGCCGA -> TAGGCGTTACGTTCAGAGGCCGAT
TTCGGCAGCTGACTCATCTTGAAT -> TCGGCAGCTGACTCATCTTGAATC
TCATAAGCCGCCTCAATCCTTACT -> CATAAGCCGCCTCAATCCTTACTG
CCCCGGACGGTAACCGATGGCCAG -> CCCGGACGGTAACCGATGGCCAGC
ATGACGGGTGCGGATGAAATATGT -> TGACGGGTGCGGATGAAATATGTC
GGAGATGAATAGGGGACAGTTGAA -> GAGATGAATAGGGGACAGTTGAAA
GACATCTGAACAGTCGATATCCAT -> ACATCTGAACAGTCGATATCCATC
CACCGTTAAGTTTTTGTCGATAGT -> ACCGTTAAGTTTTTGTCGATAGTT
ACTCAATCTAGGCGTTACGTTCAG -> CTCAATCTAGGCGTTACGTTCAGA
TCGAGCATTGAAATGCTAGGACGT -> CGAGCATTGAAATGCTAGGACGTC
GCTCGGGGCAAGTGGCATAATACC -> CTCGGGGCAAGTGGCATAATACCG
TACTTCGTTCGGCAGCTGACTCAT -> ACTTCGTTCGGCAGCTGACTCATC
GTAGGCGCGAGCGGAGACTGCCGG -> TAGGCGCGAGCGGAGACTGCCGGA
GTCCTCTGTTCATTCTAACACAGA -> TCCTCTGTTCATTCTAACACAGAG
TTCGAGGGGCACCGTTAAGTTTTT -> TCGAGGGGCACCGTTAAGTTTTTG
GTCTCGGCAGGATGAGGTTTGCCA -> TCTCGGCAGGATGAGGTTTGCCAC
AGGCTTCCCGAAGGGGAACCTCAG -> GGCTTCCCGAAGGGGAACCTCAGG
CATGTCCGAGGCACCCCGGATTCA -> ATGTCCGAGGCACCCCGGATTCAA
TTCTAACACAGAGGTACAGAACTT -> TCTAACACAGAGGTACAGAACTTT
GCCCTCACAAGAACCGTTATCTGT -> CCCTCACAAGAACCGTTATCTGTC
TAAAATTACTGATAGATAATGGTC -> AAAATTACTGATAGATAATGGTCT
CCATCAGAATCAGCGTAGAGGCCT -> CATCAGAATCAGCGTAGAGGCCTC
CACTTCATCAATTCAGCGTTGTGT -> ACTTCATCAATTCAGCGTTGTGTA
AATTAAAGGCTTCCCGAAGGGGAA -> ATTAAAGGCTTCCCGAAGGGGAAC
GAAAGTCAAGAATGTAATGGCCTG -> AAAGTCAAGAATGTAATGGCCTGC
CCAACTCAATCTAGGCGTTACGTT -> CAACTCAATCTAGGCGTTACGTTC
AATCTAGGCGTTACGTTCAGAGGC -> ATCTAGGCGTTACGTTCAGAGGCC
CGACGCTCTTTTCGAGGGGCACCG -> GACGCTCTTTTCGAGGGGCACCGT
TTGAAAGCGTGCGTTGGGAACGAT -> TGAAAGCGTGCGTTGGGAACGATA
CCCGATGGCCCTCACAAGAACCGT -> CCGATGGCCCTCACAAGAACCGTT
TCTAATGGGCTCTGGATAGTGTAT -> CTAATGGGCTCTGGATAGTGTATT
AACTTTGTTACCCGACGTGCCTAT -> ACTTTGTTACCCGACGTGCCTATA
TGGCCCTCACAAGAACCGTTATCT -> GGCCCTCACAAGAACCGTTATCTG
CGTTACGTTCAGAGGCCGATCCGG -> GTTACGTTCAGAGGCCGATCCGGA
CCTATTTGTTGTGACACAGGAAGC -> CTATTTGTTGTGACACAGGAAGCA
GTGCGCACAAACGGCTACGGTATA -> TGCGCACAAACGGCTACGGTATAG
GGCCGATCCGGAACTTACATGAAT -> GCCGATCCGGAACTTACATGAATT
ACCGGGGTATGGGTGAAGAATGGA -> CCGGGGTATGGGTGAAGAATGGAG
ATTAAAGGCTTCCCGAAGGGGAAC -> TTAAAGGCTTCCCGAAGGGGAACC
TCAGGCCGAGGTTGATTCCCCCGG -> CAGGCCGAGGTTGATTCCCCCGGA
CGAGACGTGTGGTGTGAGCAGTTA -> GAGACGTGTGGTGTGAGCAGTTAA
TGCGTTGGGAACGATACTCAGTTG -> GCGTTGGGAACGATACTCAGTTGG
GCGAGTCCTCTGTTCATTCTAACA -> CGAGTCCTCTGTTCATTCTAACAC
GGCAAGTGGCATAATACCGCACAA -> GCAAGTGGCATAATACCGCACAAT
GGTTGACAATGCATTTGATCGTCA -> GTTGACAATGCATTTGATCGTCAT
ACCGCGTAGGCGCGAGCGGAGACT -> CCGCGTAGGCGCGAGCGGAGACTG
GCTCTCACGAGACGTGTGGTGTGA -> CTCTCACGAGACGTGTGGTGTGAG
GTACAAGTAACGGATGCTGGCCGC -> TACAAGTAACGGATGCTGGCCGCC
GCACAATCTTATAATAGTCGCTTC -> CACAATCTTATAATAGTCGCTTCT
ATGCATAGAAATGACCCCGCACCT -> TGCATAGAAATGACCCCGCACCTG
GTACCCACCTTGGTGCGCACAAAC -> TACCCACCTTGGTGCGCACAAACG
GCGTAGAGGCCTCAACGTTCTGCC -> CGTAGAGGCCTCAACGTTCTGCCA
GGTACAGAACTTTGTTACCCGACG -> GTACAGAACTTTGTTACCCGACGT
GCACCGCGTAGGCGCGAGCGGAGA -> CACCGCGTAGGCGCGAGCGGAGAC
TTGGTGCGCACAAACGGCTACGGT -> TGGTGCGCACAAACGGCTACGGTA
AGTCGACTGAGCGGGATATAGTAC -> GTCGACTGAGCGGGATATAGTACC
GTCGATATCCATCTGGATGGCACC -> TCGATATCCATCTGGATGGCACCT
CGAGGGGCACCGTTAAGTTTTTGT -> GAGGGGCACCGTTAAGTTTTTGTC
TCAGATCGCCTCACTTAGTCGACT -> CAGATCGCCTCACTTAGTCGACTG
ATGTACCCACCTTGGTGCGCACAA -> TGTACCCACCTTGGTGCGCACAAA
CGACGTGCCTATAAAATTACTGAT -> GACGTGCCTATAAAATTACTGATA
TTGAAATGCTAGGACGTCTATCAG -> TGAAATGCTAGGACGTCTATCAGG
CAGGCCGAGGTTGATTCCCCCGGA -> AGGCCGAGGTTGATTCCCCCGGAC
CCTCAGGAAATTTTTGTCTGTTCG -> CTCAGGAAATTTTTGTCTGTTCGA
CCGATGGCCAGCGATGCAACAACT -> CGATGGCCAGCGATGCAACAACTG
TGTACAAGTAACGGATGCTGGCCG -> GTACAAGTAACGGATGCTGGCCGC
AAACTGAATGGTAACGGCTGACAT -> AACTGAATGGTAACGGCTGACATC
GTTCAATACATACGGGTGGTCACT -> TTCAATACATACGGGTGGTCACTC
GTTTTTGTCGATAGTTGTTTCCGC -> TTTTTGTCGATAGTTGTTTCCGCA
CGTTCAGAGGCCGATCCGGAACTT -> GTTCAGAGGCCGATCCGGAACTTA
TCAATTCAGCGTTGTGTATGCATG -> CAATTCAGCGTTGTGTATGCATGA
TCCTCTGTTCATTCTAACACAGAG -> CCTCTGTTCATTCTAACACAGAGG
ATTACTGATAGATAATGGTCTCAG -> TTACTGATAGATAATGGTCTCAGA
CAGCTCGGGGCAAGTGGCATAATA -> AGCTCGGGGCAAGTGGCATAATAC
GACGTGTGGTGTGAGCAGTTAATA -> ACGTGTGGTGTGAGCAGTTAATAG
TCCGGTTGACAATGCATTTGATCG -> CCGGTTGACAATGCATTTGATCGT
TGTGATTGTCTCGGCAGGATGAGG -> GTGATTGTCTCGGCAGGATGAGGT
CGCCGATGACTTCGCCACCTAGTC -> GCCGATGACTTCGCCACCTAGTCA
ATGCGGCTGAAACTGAATGGTAAC -> TGCGGCTGAAACTGAATGGTAACG
ATGAGGGTACCTCATCCCGATGGC -> TGAGGGTACCTCATCCCGATGGCC
CGATAGTTGTTTCCGCAAGGCAGC -> GATAGTTGTTTCCGCAAGGCAGCT
TGGGCGATGCTATGTGATTGTCTC -> GGGCGATGCTATGTGATTGTCTCG
GCGTGCGTTGGGAACGATACTCAG -> CGTGCGTTGGGAACGATACTCAGT
GAACCGTTATCTGTCCGGGTGGTC -> AACCGTTATCTGTCCGGGTGGTCG
ACAGCTCGGGGCAAGTGGCATAAT -> CAGCTCGGGGCAAGTGGCATAATA
AGTTGTTTCCGCAAGGCAGCTACA -> GTTGTTTCCGCAAGGCAGCTACAG
ACCAACTCAATCTAGGCGTTACGT -> CCAACTCAATCTAGGCGTTACGTT
GAAGCAGCCAGATGCATCTCGGTA -> AAGCAGCCAGATGCATCTCGGTAT
TTATCTGTCCGGGTGGTCGCCGAT -> TATCTGTCCGGGTGGTCGCCGATG
CCGGGGTATGGGTGAAGAATGGAG -> CGGGGTATGGGTGAAGAATGGAGG
ACCTTGGTGCGCACAAACGGCTAC -> CCTTGGTGCGCACAAACGGCTACG
GACTTCGCCACCTAGTCACCGGCA -> ACTTCGCCACCTAGTCACCGGCAC
ATAGAAGTACCCCCTCCTTCGTAG -> TAGAAGTACCCCCTCCTTCGTAGT
GAAAGATGAGGGTACCTCATCCCG -> AAAGATGAGGGTACCTCATCCCGA
GAAATTTTTGTCTGTTCGAAGCGA -> AAATTTTTGTCTGTTCGAAGCGAC
ATTTGATCGTCATAAGCCATCAGA -> TTTGATCGTCATAAGCCATCAGAA
TTTGATCGTCATAAGCCATCAGAA -> TTGATCGTCATAAGCCATCAGAAT
AAGTACCCCCTCCTTCGTAGTGGG -> AGTACCCCCTCCTTCGTAGTGGGC
TGGTCGCCGATGACTTCGCCACCT -> GGTCGCCGATGACTTCGCCACCTA
GCATCTCGGTATGAACCTCCCCTC -> CATCTCGGTATGAACCTCCCCTCA
CAAGGCAGCTACAGTTTACTTACC -> AAGGCAGCTACAGTTTACTTACCT
ACTGCTAACGAACGCTTACCAACT -> CTGCTAACGAACGCTTACCAACTC
CCGAAAGTCAAGAATGTAATGGCC -> CGAAAGTCAAGAATGTAATGGCCT
GAAGGGGAACCTCAGGAAATTTTT -> AAGGGGAACCTCAGGAAATTTTTG
AACAGTCGATATCCATCTGGATGG -> ACAGTCGATATCCATCTGGATGGC
CACCGCGTAGGCGCGAGCGGAGAC -> ACCGCGTAGGCGCGAGCGGAGACT
TGCCCTGCGCTCTCACGAGACGTG -> GCCCTGCGCTCTCACGAGACGTGT
TCGTCATAAGCCATCAGAATCAGC -> CGTCATAAGCCATCAGAATCAGCG
TTGGACATTTCCTAATAACTGCTC -> TGGACATTTCCTAATAACTGCTCT
AGGATGAGGTTTGCCACACGAAAC -> GGATGAGGTTTGCCACACGAAACC
ACGTGCCTATAAAATTACTGATAG -> CGTGCCTATAAAATTACTGATAGA
TACGAGACGCTGCCCTGCGCTCTC -> ACGAGACGCTGCCCTGCGCTCTCA
AAATTTTTGTCTGTTCGAAGCGAC -> AATTTTTGTCTGTTCGAAGCGACG
AGTTAATAGAAGTACCCCCTCCTT -> GTTAATAGAAGTACCCCCTCCTTC
CCATGTCCGAGGCACCCCGGATTC -> CATGTCCGAGGCACCCCGGATTCA
TGGATGGCACCTACGTACGAGACG -> GGATGGCACCTACGTACGAGACGC
TTTAGTTCAATACATACGGGTGGT -> TTAGTTCAATACATACGGGTGGTC
CTTAAGGTGCGACGGGGACTACGT -> TTAAGGTGCGACGGGGACTACGTC
CATAAGCCGCCTCAATCCTTACTG -> ATAAGCCGCCTCAATCCTTACTGA
GTGGTAAATTAAAGGCTTCCCGAA -> TGGTAAATTAAAGGCTTCCCGAAG
CACAGGAAGCAGCCAGATGCATCT -> ACAGGAAGCAGCCAGATGCATCTC
TGCTGGCCGCCTACCGGGGTATGG -> GCTGGCCGCCTACCGGGGTATGGG
GCTAGGACGTCTATCAGGAAGTGT -> CTAGGACGTCTATCAGGAAGTGTG
GAGGCCTCAACGTTCTGCCAGATC -> AGGCCTCAACGTTCTGCCAGATCT
GCGACGCTCTTTTCGAGGGGCACC -> CGACGCTCTTTTCGAGGGGCACCG
CAGCGTAGAGGCCTCAACGTTCTG -> AGCGTAGAGGCCTCAACGTTCTGC
AACCGGAACCAGACTGGTACATCG -> ACCGGAACCAGACTGGTACATCGG
TGTATTTCAGGCCGAGGTTGATTC -> GTATTTCAGGCCGAGGTTGATTCC
CGGTATAGTGCTCGGAACTCTATG -> GGTATAGTGCTCGGAACTCTATGT
GAATCCTATTTAGTTCAATACATA -> AATCCTATTTAGTTCAATACATAC
CAGAGGCAGTCCGGTTGACAATGC -> AGAGGCAGTCCGGTTGACAATGCA
CTCTTTACCTTGGTGCCCACTCCC -> TCTTTACCTTGGTGCCCACTCCCC
GTTCCGATCTCTTAAGGTGCGACG -> TTCCGATCTCTTAAGGTGCGACGG
GAACCAGACTGGTACATCGGAAAG -> AACCAGACTGGTACATCGGAAAGA
CTGGATGGCACCTACGTACGAGAC -> TGGATGGCACCTACGTACGAGACG
CATTTCCTAATAACTGCTCTTTAC -> ATTTCCTAATAACTGCTCTTTACC
GTTATCTGTCCGGGTGGTCGCCGA -> TTATCTGTCCGGGTGGTCGCCGAT
AACTCGTTCCGATCTCTTAAGGTG -> ACTCGTTCCGATCTCTTAAGGTGC
TCGACAGCTCGGGGCAAGTGGCAT -> CGACAGCTCGGGGCAAGTGGCATA
CTTCAGATCGCCTCACTTAGTCGA -> TTCAGATCGCCTCACTTAGTCGAC
AATTCGCGATAATAGTCAAATCGA -> ATTCGCGATAATAGTCAAATCGAG
ATGAACCTCCCCTCATAAGCCGCC -> TGAACCTCCCCTCATAAGCCGCCT
GATCTCTTAAGGTGCGACGGGGAC -> ATCTCTTAAGGTGCGACGGGGACT
CGGGATATAGTACCGTGGGGCGTG -> GGGATATAGTACCGTGGGGCGTGA
CTAGTCACCGGCACTTCATCAATT -> TAGTCACCGGCACTTCATCAATTC
TATAGTACCGTGGGGCGTGACCGT -> ATAGTACCGTGGGGCGTGACCGTA
AGAACCGTTATCTGTCCGGGTGGT -> GAACCGTTATCTGTCCGGGTGGTC
CAATCCTTACTGATGTCCATGTCC -> AATCCTTACTGATGTCCATGTCCG
CAACTGCTAACGAACGCTTACCAA -> AACTGCTAACGAACGCTTACCAAC
GATATCCATCTGGATGGCACCTAC -> ATATCCATCTGGATGGCACCTACG
GATCAATGTTAATGCATGGAATAA -> ATCAATGTTAATGCATGGAATAAA
AGATGAATAGGGGACAGTTGAAAG -> GATGAATAGGGGACAGTTGAAAGC
ATGACCCCGCACCTGAAGCTATAC -> TGACCCCGCACCTGAAGCTATACA
TCTTTTCGAGGGGCACCGTTAAGT -> CTTTTCGAGGGGCACCGTTAAGTT
AAGTGTGCTGTCCCTATTTGTTGT -> AGTGTGCTGTCCCTATTTGTTGTG
TACAGAACTTTGTTACCCGACGTG -> ACAGAACTTTGTTACCCGACGTGC
ATAGTCAAATCGAGCATTGAAATG -> TAGTCAAATCGAGCATTGAAATGC
GACTCATCTTGAATCCTATTTAGT -> ACTCATCTTGAATCCTATTTAGTT
CGTACGAGACGCTGCCCTGCGCTC -> GTACGAGACGCTGCCCTGCGCTCT
TACCTCATCCCGATGGCCCTCACA -> ACCTCATCCCGATGGCCCTCACAA
CACGAGACGTGTGGTGTGAGCAGT -> ACGAGACGTGTGGTGTGAGCAGTT
TTGCCACACGAAACCGAAGTGGTA -> TGCCACACGAAACCGAAGTGGTAA
TCGCTTCTAATGGGCTCTGGATAG -> CGCTTCTAATGGGCTCTGGATAGT
AGGAAGCAGCCAGATGCATCTCGG -> GGAAGCAGCCAGATGCATCTCGGT
GATAATAGTCAAATCGAGCATTGA -> ATAATAGTCAAATCGAGCATTGAA
ACTTTGTTACCCGACGTGCCTATA -> CTTTGTTACCCGACGTGCCTATAA
AGGGGACAGTTGAAAGCGTGCGTT -> GGGGACAGTTGAAAGCGTGCGTTG
GGGATATAGTACCGTGGGGCGTGA -> GGATATAGTACCGTGGGGCGTGAC
TTAAAGGCTTCCCGAAGGGGAACC -> TAAAGGCTTCCCGAAGGGGAACCT
GTACCGTGGGGCGTGACCGTACCG -> TACCGTGGGGCGTGACCGTACCGA
AGGGGAACCTCAGGAAATTTTTGT -> GGGGAACCTCAGGAAATTTTTGTC
TCGAGGGGCACCGTTAAGTTTTTG -> CGAGGGGCACCGTTAAGTTTTTGT
GGAAATTTTTGTCTGTTCGAAGCG -> GAAATTTTTGTCTGTTCGAAGCGA
GACGGGTGCGGATGAAATATGTCA -> ACGGGTGCGGATGAAATATGTCAG
CTTCTAATGGGCTCTGGATAGTGT -> TTCTAATGGGCTCTGGATAGTGTA
ACAACTGCTAACGAACGCTTACCA -> CAACTGCTAACGAACGCTTACCAA
TCCGCAAGGCAGCTACAGTTTACT -> CCGCAAGGCAGCTACAGTTTACTT
GATATAGTACCGTGGGGCGTGACC -> ATATAGTACCGTGGGGCGTGACCG
AGTTTACTTACCTCGACAGCTCGG -> GTTTACTTACCTCGACAGCTCGGG
ATGTTAATGCATGGAATAAAAAAA -> TGTTAATGCATGGAATAAAAAAAA
CATAAGCCATCAGAATCAGCGTAG -> ATAAGCCATCAGAATCAGCGTAGA
GGCTGAAACTGAATGGTAACGGCT -> GCTGAAACTGAATGGTAACGGCTG
GGATATAGTACCGTGGGGCGTGAC -> GATATAGTACCGTGGGGCGTGACC
CGTAGGCGCGAGCGGAGACTGCCG -> GTAGGCGCGAGCGGAGACTGCCGG
AGACTGGTACATCGGAAAGATGAG -> GACTGGTACATCGGAAAGATGAGG
GGTGGTCGCCGATGACTTCGCCAC -> GTGGTCGCCGATGACTTCGCCACC
GCTCGGAACTCTATGTACAAGTAA -> CTCGGAACTCTATGTACAAGTAAC
GCGTCAGAGGCAGTCCGGTTGACA -> CGTCAGAGGCAGTCCGGTTGACAA
GTTGCGGAGCGAGTCCTCTGTTCA -> TTGCGGAGCGAGTCCTCTGTTCAT
CATCCCGATGGCCCTCACAAGAAC -> ATCCCGATGGCCCTCACAAGAACC
GGCCTGCGTCAGAGGCAGTCCGGT -> GCCTGCGTCAGAGGCAGTCCGGTT
ATGCTATGTGATTGTCTCGGCAGG -> TGCTATGTGATTGTCTCGGCAGGA
GCACCTACGTACGAGACGCTGCCC -> CACCTACGTACGAGACGCTGCCCT
CGGGGACTACGTCACGTAGTCACT -> GGGGACTACGTCACGTAGTCACTT
TAATAGTCAAATCGAGCATTGAAA -> AATAGTCAAATCGAGCATTGAAAT
GTTGTTTCCGCAAGGCAGCTACAG -> TTGTTTCCGCAAGGCAGCTACAGT
CTCGGAACTCTATGTACAAGTAAC -> TCGGAACTCTATGTACAAGTAACG
TAGGACGTCTATCAGGAAGTGTGC -> AGGACGTCTATCAGGAAGTGTGCT
CTCCTTATGTACCCACCTTGGTGC -> TCCTTATGTACCCACCTTGGTGCG
TATTTAGTTCAATACATACGGGTG -> ATTTAGTTCAATACATACGGGTGG
CCTCATAAGCCGCCTCAATCCTTA -> CTCATAAGCCGCCTCAATCCTTAC
GTTGACAATGCATTTGATCGTCAT -> TTGACAATGCATTTGATCGTCATA
TCGTAGTGGGCGATGCTATGTGAT -> CGTAGTGGGCGATGCTATGTGATT
GATGAAATATGTCAGCACCGCGTA -> ATGAAATATGTCAGCACCGCGTAG
TAACTGCTCTTTACCTTGGTGCCC -> AACTGCTCTTTACCTTGGTGCCCA
TGGTAACGGCTGACATCTGAACAG -> GGTAACGGCTGACATCTGAACAGT
GTGTATGCATGACGGGTGCGGATG -> TGTATGCATGACGGGTGCGGATGA
GAAGTACCCCCTCCTTCGTAGTGG -> AAGTACCCCCTCCTTCGTAGTGGG
ACGCTTACCAACTCAATCTAGGCG -> CGCTTACCAACTCAATCTAGGCGT
CCCCTCCTTCGTAGTGGGCGATGC -> CCCTCCTTCGTAGTGGGCGATGCT
GTCTGTTCGAAGCGACGCTCTTTT -> TCTGTTCGAAGCGACGCTCTTTTC
CTTGAATCCTATTTAGTTCAATAC -> TTGAATCCTATTTAGTTCAATACA
GGAAAGATGAGGGTACCTCATCCC -> GAAAGATGAGGGTACCTCATCCCG
CGAACGCTTACCAACTCAATCTAG -> GAACGCTTACCAACTCAATCTAGG
AACTCAATCTAGGCGTTACGTTCA -> ACTCAATCTAGGCGTTACGTTCAG
GGATGCTGGCCGCCTACCGGGGTA -> GATGCTGGCCGCCTACCGGGGTAT
TTCCCCCGGACGGTAACCGATGGC -> TCCCCCGGACGGTAACCGATGGCC
CATTGAAATGCTAGGACGTCTATC -> ATTGAAATGCTAGGACGTCTATCA
AGCTATACAGGCGTATTAACTTGA -> GCTATACAGGCGTATTAACTTGAC
TCAGACATATTGGACATTTCCTAA -> CAGACATATTGGACATTTCCTAAT
GCCGAGGTTGATTCCCCCGGACGG -> CCGAGGTTGATTCCCCCGGACGGT
AACGATACTCAGTTGGATGCGGCT -> ACGATACTCAGTTGGATGCGGCTG
CAGGCGTATTAACTTGACTCAACC -> AGGCGTATTAACTTGACTCAACCG
TGTTCATTCTAACACAGAGGTACA -> GTTCATTCTAACACAGAGGTACAG
ATTCGCGATAATAGTCAAATCGAG -> TTCGCGATAATAGTCAAATCGAGC
TAACCGATGGCCAGCGATGCAACA -> AACCGATGGCCAGCGATGCAACAA
ATTTAGTTCAATACATACGGGTGG -> TTTAGTTCAATACATACGGGTGGT
CATCTGAACAGTCGATATCCATCT -> ATCTGAACAGTCGATATCCATCTG
TAATGCATGGAATAAAAAAAAATA -> AATGCATGGAATAAAAAAAAATAG
TCGACTGAGCGGGATATAGTACCG -> CGACTGAGCGGGATATAGTACCGT
TCGGAACTCTATGTACAAGTAACG -> CGGAACTCTATGTACAAGTAACGG
TCGCGATAATAGTCAAATCGAGCA -> CGCGATAATAGTCAAATCGAGCAT
CTATACAGGCGTATTAACTTGACT -> TATACAGGCGTATTAACTTGACTC
GAGACGCTGCCCTGCGCTCTCACG -> AGACGCTGCCCTGCGCTCTCACGA
TGCCGGAACTCGTTCCGATCTCTT -> GCCGGAACTCGTTCCGATCTCTTA
TGGGAACGATACTCAGTTGGATGC -> GGGAACGATACTCAGTTGGATGCG
TCAGCACCGCGTAGGCGCGAGCGG -> CAGCACCGCGTAGGCGCGAGCGGA
CCTTGGTGCGCACAAACGGCTACG -> CTTGGTGCGCACAAACGGCTACGG
CTAATGGGCTCTGGATAGTGTATT -> TAATGGGCTCTGGATAGTGTATTT
CTCACAAGAACCGTTATCTGTCCG -> TCACAAGAACCGTTATCTGTCCGG
TGCCACACGAAACCGAAGTGGTAA -> GCCACACGAAACCGAAGTGGTAAA
GTCAAATCGAGCATTGAAATGCTA -> TCAAATCGAGCATTGAAATGCTAG
GTTTACTTCGTTCGGCAGCTGACT -> TTTACTTCGTTCGGCAGCTGACTC
AGCTCGGGGCAAGTGGCATAATAC -> GCTCGGGGCAAGTGGCATAATACC
ATAAAAAAAAATAGCGGGAGATGA -> TAAAAAAAAATAGCGGGAGATGAA
CTGAAACTGAATGGTAACGGCTGA -> TGAAACTGAATGGTAACGGCTGAC
GCGGAGCGAGTCCTCTGTTCATTC -> CGGAGCGAGTCCTCTGTTCATTCT
AATGGCCTGCGTCAGAGGCAGTCC -> ATGGCCTGCGTCAGAGGCAGTCCG
TTCCCGAAGGGGAACCTCAGGAAA -> TCCCGAAGGGGAACCTCAGGAAAT
TGTACCCACCTTGGTGCGCACAAA -> GTACCCACCTTGGTGCGCACAAAC
TCCTTACTGATGTCCATGTCCGAG -> CCTTACTGATGTCCATGTCCGAGG
ATGAGGTTTGCCACACGAAACCGA -> TGAGGTTTGCCACACGAAACCGAA
CAGACTGGTACATCGGAAAGATGA -> AGACTGGTACATCGGAAAGATGAG
TACCCGACGTGCCTATAAAATTAC -> ACCCGACGTGCCTATAAAATTACT
TGCAACAACTGCTAACGAACGCTT -> GCAACAACTGCTAACGAACGCTTA
GGTTGCGGAGCGAGTCCTCTGTTC -> GTTGCGGAGCGAGTCCTCTGTTCA
AACCTCCCCTCATAAGCCGCCTCA -> ACCTCCCCTCATAAGCCGCCTCAA
GAGGTACAGAACTTTGTTACCCGA -> AGGTACAGAACTTTGTTACCCGAC
CGTTGTGTATGCATGACGGGTGCG -> GTTGTGTATGCATGACGGGTGCGG
CTTCCCGAAGGGGAACCTCAGGAA -> TTCCCGAAGGGGAACCTCAGGAAA
TGTCCCTATTTGTTGTGACACAGG -> GTCCCTATTTGTTGTGACACAGGA
TTCAGCGTTGTGTATGCATGACGG -> TCAGCGTTGTGTATGCATGACGGG
TTGACAATGCATTTGATCGTCATA -> TGACAATGCATTTGATCGTCATAA
TACCCCCTCCTTCGTAGTGGGCGA -> ACCCCCTCCTTCGTAGTGGGCGAT
TTACCTCGACAGCTCGGGGCAAGT -> TACCTCGACAGCTCGGGGCAAGTG
GCCACACGAAACCGAAGTGGTAAA -> CCACACGAAACCGAAGTGGTAAAT
ATGTACAAGTAACGGATGCTGGCC -> TGTACAAGTAACGGATGCTGGCCG
TACTCAGTTGGATGCGGCTGAAAC -> ACTCAGTTGGATGCGGCTGAAACT
ATCAGAATCAGCGTAGAGGCCTCA -> TCAGAATCAGCGTAGAGGCCTCAA
AGAGGTACAGAACTTTGTTACCCG -> GAGGTACAGAACTTTGTTACCCGA
CGCGAGCGGAGACTGCCGGAACTC -> GCGAGCGGAGACTGCCGGAACTCG
CACAATCTTATAATAGTCGCTTCT -> ACAATCTTATAATAGTCGCTTCTA
GGGGAACCTCAGGAAATTTTTGTC -> GGGAACCTCAGGAAATTTTTGTCT
ACAGGAAGCAGCCAGATGCATCTC -> CAGGAAGCAGCCAGATGCATCTCG
GAATGGAGGTTGCGGAGCGAGTCC -> AATGGAGGTTGCGGAGCGAGTCCT
TCTGGATAGTGTATTTCAGGCCGA -> CTGGATAGTGTATTTCAGGCCGAG
CGTTCTGCCAGATCTTGATGCATA -> GTTCTGCCAGATCTTGATGCATAG
CAAGTAACGGATGCTGGCCGCCTA -> AAGTAACGGATGCTGGCCGCCTAC
CTCCCCGCTTCAGATCGCCTCACT -> TCCCCGCTTCAGATCGCCTCACTT
GATGGCCAGCGATGCAACAACTGC -> ATGGCCAGCGATGCAACAACTGCT
CGAAACCGAAGTGGTAAATTAAAG -> GAAACCGAAGTGGTAAATTAAAGG
CTTAGTCGACTGAGCGGGATATAG -> TTAGTCGACTGAGCGGGATATAGT
GAAGCGACGCTCTTTTCGAGGGGC -> AAGCGACGCTCTTTTCGAGGGGCA
TTCAGGCCGAGGTTGATTCCCCCG -> TCAGGCCGAGGTTGATTCCCCCGG
GCCATCAGAATCAGCGTAGAGGCC -> CCATCAGAATCAGCGTAGAGGCCT
GACTGAGCGGGATATAGTACCGTG -> ACTGAGCGGGATATAGTACCGTGG
TTAATAGAAGTACCCCCTCCTTCG -> TAATAGAAGTACCCCCTCCTTCGT
CACAGAGGTACAGAACTTTGTTAC -> ACAGAGGTACAGAACTTTGTTACC
GCGGGAGATGAATAGGGGACAGTT -> CGGGAGATGAATAGGGGACAGTTG
ATACATACGGGTGGTCACTCCTTA -> TACATACGGGTGGTCACTCCTTAT
CCCGCACCTGAAGCTATACAGGCG -> CCGCACCTGAAGCTATACAGGCGT
CTCAACGTTCTGCCAGATCTTGAT -> TCAACGTTCTGCCAGATCTTGATG
CAAGAATGTAATGGCCTGCGTCAG -> AAGAATGTAATGGCCTGCGTCAGA
TGAATCCTATTTAGTTCAATACAT -> GAATCCTATTTAGTTCAATACATA
AACTGAATGGTAACGGCTGACATC -> ACTGAATGGTAACGGCTGACATCT
ACGGGTGCGGATGAAATATGTCAG -> CGGGTGCGGATGAAATATGTCAGC
GGAGACTGCCGGAACTCGTTCCGA -> GAGACTGCCGGAACTCGTTCCGAT
CACAAACGGCTACGGTATAGTGCT -> ACAAACGGCTACGGTATAGTGCTC
GTATTAACTTGACTCAACCGGAAC -> TATTAACTTGACTCAACCGGAACC
TCAGAGGCAGTCCGGTTGACAATG -> CAGAGGCAGTCCGGTTGACAATGC
GATAATGGTCTCAGACATATTGGA -> ATAATGGTCTCAGACATATTGGAC
CGGAACTCTATGTACAAGTAACGG -> GGAACTCTATGTACAAGTAACGGA
GTCACTCCTTATGTACCCACCTTG -> TCACTCCTTATGTACCCACCTTGG
GCCGCCTACCGGGGTATGGGTGAA -> CCGCCTACCGGGGTATGGGTGAAG
ATCGTCATAAGCCATCAGAATCAG -> TCGTCATAAGCCATCAGAATCAGC
TACATGAATTCGCGATAATAGTCA -> ACATGAATTCGCGATAATAGTCAA
TGATTCCCCCGGACGGTAACCGAT -> GATTCCCCCGGACGGTAACCGATG
TCTAGGCGTTACGTTCAGAGGCCG -> CTAGGCGTTACGTTCAGAGGCCGA
CCGATCTCTTAAGGTGCGACGGGG -> CGATCTCTTAAGGTGCGACGGGGA
CCGGTTGACAATGCATTTGATCGT -> CGGTTGACAATGCATTTGATCGTC
GCCTCACTTAGTCGACTGAGCGGG -> CCTCACTTAGTCGACTGAGCGGGA
AGTCCTCTGTTCATTCTAACACAG -> GTCCTCTGTTCATTCTAACACAGA
TGCCCTGTTTACTTCGTTCGGCAG -> GCCCTGTTTACTTCGTTCGGCAGC
AGCTACAGTTTACTTACCTCGACA -> GCTACAGTTTACTTACCTCGACAG
GCATTGAAATGCTAGGACGTCTAT -> CATTGAAATGCTAGGACGTCTATC
AGGTGCGACGGGGACTACGTCACG -> GGTGCGACGGGGACTACGTCACGT
CAGGATGAGGTTTGCCACACGAAA -> AGGATGAGGTTTGCCACACGAAAC
ATCCTATTTAGTTCAATACATACG -> TCCTATTTAGTTCAATACATACGG
GTGGGCGATGCTATGTGATTGTCT -> TGGGCGATGCTATGTGATTGTCTC
GCTTCAGATCGCCTCACTTAGTCG -> CTTCAGATCGCCTCACTTAGTCGA
GGCTGACATCTGAACAGTCGATAT -> GCTGACATCTGAACAGTCGATATC
TAGTCGACTGAGCGGGATATAGTA -> AGTCGACTGAGCGGGATATAGTAC
CACGAAACCGAAGTGGTAAATTAA -> ACGAAACCGAAGTGGTAAATTAAA
ACTGATAGATAATGGTCTCAGACA -> CTGATAGATAATGGTCTCAGACAT
TATGTGATTGTCTCGGCAGGATGA -> ATGTGATTGTCTCGGCAGGATGAG
TGAATTCGCGATAATAGTCAAATC -> GAATTCGCGATAATAGTCAAATCG
AGTCGCTTCTAATGGGCTCTGGAT -> GTCGCTTCTAATGGGCTCTGGATA
GGAAGCAGCCAGATGCATCTCGGT -> GAAGCAGCCAGATGCATCTCGGTA
TGGCATAATACCGCACAATCTTAT -> GGCATAATACCGCACAATCTTATA
TTCAGAGGCCGATCCGGAACTTAC -> TCAGAGGCCGATCCGGAACTTACA
GAGATGAATAGGGGACAGTTGAAA -> AGATGAATAGGGGACAGTTGAAAG
TAATAGTCGCTTCTAATGGGCTCT -> AATAGTCGCTTCTAATGGGCTCTG
GGCCGCCTACCGGGGTATGGGTGA -> GCCGCCTACCGGGGTATGGGTGAA
ACATACGGGTGGTCACTCCTTATG -> CATACGGGTGGTCACTCCTTATGT
CAAGTGGCATAATACCGCACAATC -> AAGTGGCATAATACCGCACAATCT
AATATGTCAGCACCGCGTAGGCGC -> ATATGTCAGCACCGCGTAGGCGCG
TAACGGATGCTGGCCGCCTACCGG -> AACGGATGCTGGCCGCCTACCGGG
GCGATCAATGTTAATGCATGGAAT -> CGATCAATGTTAATGCATGGAATA
TAATGGGCTCTGGATAGTGTATTT -> AATGGGCTCTGGATAGTGTATTTC
CGAAGGGGAACCTCAGGAAATTTT -> GAAGGGGAACCTCAGGAAATTTTT
CGCTCTCACGAGACGTGTGGTGTG -> GCTCTCACGAGACGTGTGGTGTGA
ACGTGTGGTGTGAGCAGTTAATAG -> CGTGTGGTGTGAGCAGTTAATAGA
TGCTATGTGATTGTCTCGGCAGGA -> GCTATGTGATTGTCTCGGCAGGAT
AACCGAAGTGGTAAATTAAAGGCT -> ACCGAAGTGGTAAATTAAAGGCTT
CGTGACCGTACCGAAAGTCAAGAA -> GTGACCGTACCGAAAGTCAAGAAT
CGTGCCTATAAAATTACTGATAGA -> GTGCCTATAAAATTACTGATAGAT
TACAGGCGTATTAACTTGACTCAA -> ACAGGCGTATTAACTTGACTCAAC
GTGGGGCGTGACCGTACCGAAAGT -> TGGGGCGTGACCGTACCGAAAGTC
ATGGCCCTCACAAGAACCGTTATC -> TGGCCCTCACAAGAACCGTTATCT
CGGAAAGATGAGGGTACCTCATCC -> GGAAAGATGAGGGTACCTCATCCC
GAGACGTGTGGTGTGAGCAGTTAA -> AGACGTGTGGTGTGAGCAGTTAAT
GGGTACCTCATCCCGATGGCCCTC -> GGTACCTCATCCCGATGGCCCTCA
CTTATGTACCCACCTTGGTGCGCA -> TTATGTACCCACCTTGGTGCGCAC
ATTTGTTGTGACACAGGAAGCAGC -> TTTGTTGTGACACAGGAAGCAGCC
CACTCCTTATGTACCCACCTTGGT -> ACTCCTTATGTACCCACCTTGGTG
CTAGGACGTCTATCAGGAAGTGTG -> TAGGACGTCTATCAGGAAGTGTGC
AGATAATGGTCTCAGACATATTGG -> GATAATGGTCTCAGACATATTGGA
ACCTCAGGAAATTTTTGTCTGTTC -> CCTCAGGAAATTTTTGTCTGTTCG
TATAAAATTACTGATAGATAATGG -> ATAAAATTACTGATAGATAATGGT
TCGCCGATGACTTCGCCACCTAGT -> CGCCGATGACTTCGCCACCTAGTC
TGTGGTGTGAGCAGTTAATAGAAG -> GTGGTGTGAGCAGTTAATAGAAGT
CGCACAAACGGCTACGGTATAGTG -> GCACAAACGGCTACGGTATAGTGC
TAAAGCCCAGCTTGCCCTGTTTAC -> AAAGCCCAGCTTGCCCTGTTTACT
AGCTGACTCATCTTGAATCCTATT -> GCTGACTCATCTTGAATCCTATTT
CGTCATAAGCCATCAGAATCAGCG -> GTCATAAGCCATCAGAATCAGCGT
GCGCGAGCGGAGACTGCCGGAACT -> CGCGAGCGGAGACTGCCGGAACTC
CATCAGAATCAGCGTAGAGGCCTC -> ATCAGAATCAGCGTAGAGGCCTCA
CGACAGCTCGGGGCAAGTGGCATA -> GACAGCTCGGGGCAAGTGGCATAA
GACCCCGCACCTGAAGCTATACAG -> ACCCCGCACCTGAAGCTATACAGG
TCTCACGAGACGTGTGGTGTGAGC -> CTCACGAGACGTGTGGTGTGAGCA
GGATTCAATAAAGCCCAGCTTGCC -> GATTCAATAAAGCCCAGCTTGCCC
AGCAGCCAGATGCATCTCGGTATG -> GCAGCCAGATGCATCTCGGTATGA
TCGTTCGGCAGCTGACTCATCTTG -> CGTTCGGCAGCTGACTCATCTTGA
GAAGCTATACAGGCGTATTAACTT -> AAGCTATACAGGCGTATTAACTTG
AATTTTTGTCTGTTCGAAGCGACG -> ATTTTTGTCTGTTCGAAGCGACGC
CGAGCATTGAAATGCTAGGACGTC -> GAGCATTGAAATGCTAGGACGTCT
CGTAGTGGGCGATGCTATGTGATT -> GTAGTGGGCGATGCTATGTGATTG
GGTCACTCCTTATGTACCCACCTT -> GTCACTCCTTATGTACCCACCTTG
GGGGCAAGTGGCATAATACCGCAC -> GGGCAAGTGGCATAATACCGCACA
AGCACCGCGTAGGCGCGAGCGGAG -> GCACCGCGTAGGCGCGAGCGGAGA
CACCTGAAGCTATACAGGCGTATT -> ACCTGAAGCTATACAGGCGTATTA
GCTAACGAACGCTTACCAACTCAA -> CTAACGAACGCTTACCAACTCAAT
TCTATCAGGAAGTGTGCTGTCCCT -> CTATCAGGAAGTGTGCTGTCCCTA
GTGCCCACTCCCCGCTTCAGATCG -> TGCCCACTCCCCGCTTCAGATCGC
ACACGAAACCGAAGTGGTAAATTA -> CACGAAACCGAAGTGGTAAATTAA
GGAGGTTGCGGAGCGAGTCCTCTG -> GAGGTTGCGGAGCGAGTCCTCTGT
CCGAAGTGGTAAATTAAAGGCTTC -> CGAAGTGGTAAATTAAAGGCTTCC
TGTGCTGTCCCTATTTGTTGTGAC -> GTGCTGTCCCTATTTGTTGTGACA
TTAATGCATGGAATAAAAAAAAAT -> TAATGCATGGAATAAAAAAAAATA
ACTGCTCTTTACCTTGGTGCCCAC -> CTGCTCTTTACCTTGGTGCCCACT
CGTTCCGATCTCTTAAGGTGCGAC -> GTTCCGATCTCTTAAGGTGCGACG
TCCATCTGGATGGCACCTACGTAC -> CCATCTGGATGGCACCTACGTACG
TCTAACACAGAGGTACAGAACTTT -> CTAACACAGAGGTACAGAACTTTG
ATCAGCGTAGAGGCCTCAACGTTC -> TCAGCGTAGAGGCCTCAACGTTCT
TGGTGTGAGCAGTTAATAGAAGTA -> GGTGTGAGCAGTTAATAGAAGTAC
ACAGAGGTACAGAACTTTGTTACC -> CAGAGGTACAGAACTTTGTTACCC
ATTTTTGTCTGTTCGAAGCGACGC -> TTTTTGTCTGTTCGAAGCGACGCT
GGCATAATACCGCACAATCTTATA -> GCATAATACCGCACAATCTTATAA
CAGCCAGATGCATCTCGGTATGAA -> AGCCAGATGCATCTCGGTATGAAC
CACCGGCACTTCATCAATTCAGCG -> ACCGGCACTTCATCAATTCAGCGT
TGCTCGGAACTCTATGTACAAGTA -> GCTCGGAACTCTATGTACAAGTAA
ATTGTCTCGGCAGGATGAGGTTTG -> TTGTCTCGGCAGGATGAGGTTTGC
GAGGCAGTCCGGTTGACAATGCAT -> AGGCAGTCCGGTTGACAATGCATT
CTATTTGTTGTGACACAGGAAGCA -> TATTTGTTGTGACACAGGAAGCAG
TTCGCCACCTAGTCACCGGCACTT -> TCGCCACCTAGTCACCGGCACTTC
CAGCTACAGTTTACTTACCTCGAC -> AGCTACAGTTTACTTACCTCGACA
CCCCCGGACGGTAACCGATGGCCA -> CCCCGGACGGTAACCGATGGCCAG
CGGGTGGTCACTCCTTATGTACCC -> GGGTGGTCACTCCTTATGTACCCA
CCCCGCTTCAGATCGCCTCACTTA -> CCCGCTTCAGATCGCCTCACTTAG
TCTTAAGGTGCGACGGGGACTACG -> CTTAAGGTGCGACGGGGACTACGT
CGGGAGATGAATAGGGGACAGTTG -> GGGAGATGAATAGGGGACAGTTGA
GCTACAGTTTACTTACCTCGACAG -> CTACAGTTTACTTACCTCGACAGC
GTTACCCGACGTGCCTATAAAATT -> TTACCCGACGTGCCTATAAAATTA
GCCAGATCTTGATGCATAGAAATG -> CCAGATCTTGATGCATAGAAATGA
GATGCTATGTGATTGTCTCGGCAG -> ATGCTATGTGATTGTCTCGGCAGG
CATCAATTCAGCGTTGTGTATGCA -> ATCAATTCAGCGTTGTGTATGCAT
CTTTGTTACCCGACGTGCCTATAA -> TTTGTTACCCGACGTGCCTATAAA
CAAGAACCGTTATCTGTCCGGGTG -> AAGAACCGTTATCTGTCCGGGTGG
CGTGCGTTGGGAACGATACTCAGT -> GTGCGTTGGGAACGATACTCAGTT
CCTAATAACTGCTCTTTACCTTGG -> CTAATAACTGCTCTTTACCTTGGT
CGGGGCAAGTGGCATAATACCGCA -> GGGGCAAGTGGCATAATACCGCAC
AAATATGTCAGCACCGCGTAGGCG -> AATATGTCAGCACCGCGTAGGCGC
ATACAGGCGTATTAACTTGACTCA -> TACAGGCGTATTAACTTGACTCAA
TTGCCCTGTTTACTTCGTTCGGCA -> TGCCCTGTTTACTTCGTTCGGCAG
ACAATCTTATAATAGTCGCTTCTA -> CAATCTTATAATAGTCGCTTCTAA
TTCTGCCAGATCTTGATGCATAGA -> TCTGCCAGATCTTGATGCATAGAA
GTCACCGGCACTTCATCAATTCAG -> TCACCGGCACTTCATCAATTCAGC
CTCAACCGGAACCAGACTGGTACA -> TCAACCGGAACCAGACTGGTACAT
GAATGGTAACGGCTGACATCTGAA -> AATGGTAACGGCTGACATCTGAAC
AAATGACCCCGCACCTGAAGCTAT -> AATGACCCCGCACCTGAAGCTATA
ATAAAATTACTGATAGATAATGGT -> TAAAATTACTGATAGATAATGGTC
ATAGTACCGTGGGGCGTGACCGTA -> TAGTACCGTGGGGCGTGACCGTAC
CCCCGCACCTGAAGCTATACAGGC -> CCCGCACCTGAAGCTATACAGGCG
GCCGGAACTCGTTCCGATCTCTTA -> CCGGAACTCGTTCCGATCTCTTAA
GGCACCCCGGATTCAATAAAGCCC -> GCACCCCGGATTCAATAAAGCCCA
CGGCTGAAACTGAATGGTAACGGC -> GGCTGAAACTGAATGGTAACGGCT
GACGCTCTTTTCGAGGGGCACCGT -> ACGCTCTTTTCGAGGGGCACCGTT
GCACCTGAAGCTATACAGGCGTAT -> CACCTGAAGCTATACAGGCGTATT
GCATAGAAATGACCCCGCACCTGA -> CATAGAAATGACCCCGCACCTGAA
GACTGGTACATCGGAAAGATGAGG -> ACTGGTACATCGGAAAGATGAGGG
TTGTGTATGCATGACGGGTGCGGA -> TGTGTATGCATGACGGGTGCGGAT
GACGCTGCCCTGCGCTCTCACGAG -> ACGCTGCCCTGCGCTCTCACGAGA
TAAAAAAAAATAGCGGGAGATGAA -> AAAAAAAAATAGCGGGAGATGAAT
AACACAGAGGTACAGAACTTTGTT -> ACACAGAGGTACAGAACTTTGTTA
AAATCGAGCATTGAAATGCTAGGA -> AATCGAGCATTGAAATGCTAGGAC
TAGATAATGGTCTCAGACATATTG -> AGATAATGGTCTCAGACATATTGG
GCTGCCCTGCGCTCTCACGAGACG -> CTGCCCTGCGCTCTCACGAGACGT
AGAACTTTGTTACCCGACGTGCCT -> GAACTTTGTTACCCGACGTGCCTA
TATTGGACATTTCCTAATAACTGC -> ATTGGACATTTCCTAATAACTGCT
GGGCGATGCTATGTGATTGTCTCG -> GGCGATGCTATGTGATTGTCTCGG
TGCATTTGATCGTCATAAGCCATC -> GCATTTGATCGTCATAAGCCATCA
TCTTGATGCATAGAAATGACCCCG -> CTTGATGCATAGAAATGACCCCGC
GTACATCGGAAAGATGAGGGTACC -> TACATCGGAAAGATGAGGGTACCT
ACAGGCGTATTAACTTGACTCAAC -> CAGGCGTATTAACTTGACTCAACC
CATCTTGAATCCTATTTAGTTCAA -> ATCTTGAATCCTATTTAGTTCAAT
CGAGACGCTGCCCTGCGCTCTCAC -> GAGACGCTGCCCTGCGCTCTCACG
CTCGGGGCAAGTGGCATAATACCG -> TCGGGGCAAGTGGCATAATACCGC
CCGCCTACCGGGGTATGGGTGAAG -> CGCCTACCGGGGTATGGGTGAAGA
CTTATAATAGTCGCTTCTAATGGG -> TTATAATAGTCGCTTCTAATGGGC
CCGTACCGAAAGTCAAGAATGTAA -> CGTACCGAAAGTCAAGAATGTAAT
CGATCTCTTAAGGTGCGACGGGGA -> GATCTCTTAAGGTGCGACGGGGAC
GGGACTACGTCACGTAGTCACTTG -> GGACTACGTCACGTAGTCACTTGA
GGGCACCGTTAAGTTTTTGTCGAT -> GGCACCGTTAAGTTTTTGTCGATA
ACCTAGTCACCGGCACTTCATCAA -> CCTAGTCACCGGCACTTCATCAAT
TCGCCTCACTTAGTCGACTGAGCG -> CGCCTCACTTAGTCGACTGAGCGG
TAGAAGTACCCCCTCCTTCGTAGT -> AGAAGTACCCCCTCCTTCGTAGTG
TGTGTATGCATGACGGGTGCGGAT -> GTGTATGCATGACGGGTGCGGATG
CATCGGAAAGATGAGGGTACCTCA -> ATCGGAAAGATGAGGGTACCTCAT
GTGATTGTCTCGGCAGGATGAGGT -> TGATTGTCTCGGCAGGATGAGGTT
AGCGGAGACTGCCGGAACTCGTTC -> GCGGAGACTGCCGGAACTCGTTCC
TGTTTACTTCGTTCGGCAGCTGAC -> GTTTACTTCGTTCGGCAGCTGACT
AAGAACCGTTATCTGTCCGGGTGG -> AGAACCGTTATCTGTCCGGGTGGT
GTAATGGCCTGCGTCAGAGGCAGT -> TAATGGCCTGCGTCAGAGGCAGTC
AGTCAAATCGAGCATTGAAATGCT -> GTCAAATCGAGCATTGAAATGCTA
CTATCAGGAAGTGTGCTGTCCCTA -> TATCAGGAAGTGTGCTGTCCCTAT
GTAACCGATGGCCAGCGATGCAAC -> TAACCGATGGCCAGCGATGCAACA
TCAATGTTAATGCATGGAATAAAA -> CAATGTTAATGCATGGAATAAAAA
AAGCGTGCGTTGGGAACGATACTC -> AGCGTGCGTTGGGAACGATACTCA
CTGCCAGATCTTGATGCATAGAAA -> TGCCAGATCTTGATGCATAGAAAT
GCGATAATAGTCAAATCGAGCATT -> CGATAATAGTCAAATCGAGCATTG
ATTCCCCCGGACGGTAACCGATGG -> TTCCCCCGGACGGTAACCGATGGC
TACGTTCAGAGGCCGATCCGGAAC -> ACGTTCAGAGGCCGATCCGGAACT
ATGAAATATGTCAGCACCGCGTAG -> TGAAATATGTCAGCACCGCGTAGG
ATCGCCTCACTTAGTCGACTGAGC -> TCGCCTCACTTAGTCGACTGAGCG
GGTGCGCACAAACGGCTACGGTAT -> GTGCGCACAAACGGCTACGGTATA
GCGTATTAACTTGACTCAACCGGA -> CGTATTAACTTGACTCAACCGGAA
GGCAGTCCGGTTGACAATGCATTT -> GCAGTCCGGTTGACAATGCATTTG
TCGGCAGCTGACTCATCTTGAATC -> CGGCAGCTGACTCATCTTGAATCC
CGTCAGAGGCAGTCCGGTTGACAA -> GTCAGAGGCAGTCCGGTTGACAAT
ATCAGGAAGTGTGCTGTCCCTATT -> TCAGGAAGTGTGCTGTCCCTATTT
CTGAAGCTATACAGGCGTATTAAC -> TGAAGCTATACAGGCGTATTAACT
CTATGTGATTGTCTCGGCAGGATG -> TATGTGATTGTCTCGGCAGGATGA
GACACAGGAAGCAGCCAGATGCAT -> ACACAGGAAGCAGCCAGATGCATC
CTACGGTATAGTGCTCGGAACTCT -> TACGGTATAGTGCTCGGAACTCTA
CAACAACTGCTAACGAACGCTTAC -> AACAACTGCTAACGAACGCTTACC
CCTCACAAGAACCGTTATCTGTCC -> CTCACAAGAACCGTTATCTGTCCG
CCCGGACGGTAACCGATGGCCAGC -> CCGGACGGTAACCGATGGCCAGCG
GAGGGTACCTCATCCCGATGGCCC -> AGGGTACCTCATCCCGATGGCCCT
GTGCTGTCCCTATTTGTTGTGACA -> TGCTGTCCCTATTTGTTGTGACAC
AGGTTTGCCACACGAAACCGAAGT -> GGTTTGCCACACGAAACCGAAGTG
AATACATACGGGTGGTCACTCCTT -> ATACATACGGGTGGTCACTCCTTA
TGACCCCGCACCTGAAGCTATACA -> GACCCCGCACCTGAAGCTATACAG
CAGCGATGCAACAACTGCTAACGA -> AGCGATGCAACAACTGCTAACGAA
CCGCTTCAGATCGCCTCACTTAGT -> CGCTTCAGATCGCCTCACTTAGTC
GTAACGGATGCTGGCCGCCTACCG -> TAACGGATGCTGGCCGCCTACCGG
TCAAATCGAGCATTGAAATGCTAG -> CAAATCGAGCATTGAAATGCTAGG
GGCACCGTTAAGTTTTTGTCGATA -> GCACCGTTAAGTTTTTGTCGATAG
AAGGCTTCCCGAAGGGGAACCTCA -> AGGCTTCCCGAAGGGGAACCTCAG
TAACTTGACTCAACCGGAACCAGA -> AACTTGACTCAACCGGAACCAGAC
TTTGTCGATAGTTGTTTCCGCAAG -> TTGTCGATAGTTGTTTCCGCAAGG
ACATGAATTCGCGATAATAGTCAA -> CATGAATTCGCGATAATAGTCAAA
AAAGGCTTCCCGAAGGGGAACCTC -> AAGGCTTCCCGAAGGGGAACCTCA
TGGGCTCTGGATAGTGTATTTCAG -> GGGCTCTGGATAGTGTATTTCAGG
GACGGGGACTACGTCACGTAGTCA -> ACGGGGACTACGTCACGTAGTCAC
CAATACATACGGGTGGTCACTCCT -> AATACATACGGGTGGTCACTCCTT
GCGTTGTGTATGCATGACGGGTGC -> CGTTGTGTATGCATGACGGGTGCG
GGTAACGGCTGACATCTGAACAGT -> GTAACGGCTGACATCTGAACAGTC
TTTGTTGTGACACAGGAAGCAGCC -> TTGTTGTGACACAGGAAGCAGCCA
CGGCAGCTGACTCATCTTGAATCC -> GGCAGCTGACTCATCTTGAATCCT
TAGTCACCGGCACTTCATCAATTC -> AGTCACCGGCACTTCATCAATTCA
AAAGTCAAGAATGTAATGGCCTGC -> AAGTCAAGAATGTAATGGCCTGCG
TACATACGGGTGGTCACTCCTTAT -> ACATACGGGTGGTCACTCCTTATG
GAAGTGGTAAATTAAAGGCTTCCC -> AAGTGGTAAATTAAAGGCTTCCCG
GCTGACTCATCTTGAATCCTATTT -> CTGACTCATCTTGAATCCTATTTA
ACAAACGGCTACGGTATAGTGCTC -> CAAACGGCTACGGTATAGTGCTCG
AGCAGTTAATAGAAGTACCCCCTC -> GCAGTTAATAGAAGTACCCCCTCC
CACTCCCCGCTTCAGATCGCCTCA -> ACTCCCCGCTTCAGATCGCCTCAC
GAACTCTATGTACAAGTAACGGAT -> AACTCTATGTACAAGTAACGGATG
CCGATCCGGAACTTACATGAATTC -> CGATCCGGAACTTACATGAATTCG
GAGGGGCACCGTTAAGTTTTTGTC -> AGGGGCACCGTTAAGTTTTTGTCG
ACCGGCACTTCATCAATTCAGCGT -> CCGGCACTTCATCAATTCAGCGTT
AGGACGTCTATCAGGAAGTGTGCT -> GGACGTCTATCAGGAAGTGTGCTG
GTTCTGCCAGATCTTGATGCATAG -> TTCTGCCAGATCTTGATGCATAGA
GTCGACTGAGCGGGATATAGTACC -> TCGACTGAGCGGGATATAGTACCG
CGAAAGTCAAGAATGTAATGGCCT -> GAAAGTCAAGAATGTAATGGCCTG
AGCGAGTCCTCTGTTCATTCTAAC -> GCGAGTCCTCTGTTCATTCTAACA
GATGGCACCTACGTACGAGACGCT -> ATGGCACCTACGTACGAGACGCTG
TACGTACGAGACGCTGCCCTGCGC -> ACGTACGAGACGCTGCCCTGCGCT
AATAGTCGCTTCTAATGGGCTCTG -> ATAGTCGCTTCTAATGGGCTCTGG
TTTCGAGGGGCACCGTTAAGTTTT -> TTCGAGGGGCACCGTTAAGTTTTT
GTGGTCACTCCTTATGTACCCACC -> TGGTCACTCCTTATGTACCCACCT
GAACCTCAGGAAATTTTTGTCTGT -> AACCTCAGGAAATTTTTGTCTGTT
GTGGTGTGAGCAGTTAATAGAAGT -> TGGTGTGAGCAGTTAATAGAAGTA
CGATGACTTCGCCACCTAGTCACC -> GATGACTTCGCCACCTAGTCACCG
CTCAGACATATTGGACATTTCCTA -> TCAGACATATTGGACATTTCCTAA
ACACAGGAAGCAGCCAGATGCATC -> CACAGGAAGCAGCCAGATGCATCT
GGTTTGCCACACGAAACCGAAGTG -> GTTTGCCACACGAAACCGAAGTGG
AAAAAAAATAGCGGGAGATGAATA -> AAAAAAATAGCGGGAGATGAATAG
CTTCATCAATTCAGCGTTGTGTAT -> TTCATCAATTCAGCGTTGTGTATG
CCTCGACAGCTCGGGGCAAGTGGC -> CTCGACAGCTCGGGGCAAGTGGCA
AATCTTATAATAGTCGCTTCTAAT -> ATCTTATAATAGTCGCTTCTAATG
GTACCGAAAGTCAAGAATGTAATG -> TACCGAAAGTCAAGAATGTAATGG
CGATGCTATGTGATTGTCTCGGCA -> GATGCTATGTGATTGTCTCGGCAG
TTGATGCATAGAAATGACCCCGCA -> TGATGCATAGAAATGACCCCGCAC
TGGGTGAAGAATGGAGGTTGCGGA -> GGGTGAAGAATGGAGGTTGCGGAG
GGATGCGGCTGAAACTGAATGGTA -> GATGCGGCTGAAACTGAATGGTAA
ACGAGACGTGTGGTGTGAGCAGTT -> CGAGACGTGTGGTGTGAGCAGTTA
TTGAATCCTATTTAGTTCAATACA -> TGAATCCTATTTAGTTCAATACAT
CGCCTCACTTAGTCGACTGAGCGG -> GCCTCACTTAGTCGACTGAGCGGG
TGAAACTGAATGGTAACGGCTGAC -> GAAACTGAATGGTAACGGCTGACA
GCGGGATATAGTACCGTGGGGCGT -> CGGGATATAGTACCGTGGGGCGTG
TAATGGCCTGCGTCAGAGGCAGTC -> AATGGCCTGCGTCAGAGGCAGTCC
CCTCAATCCTTACTGATGTCCATG -> CTCAATCCTTACTGATGTCCATGT
ACGTTCAGAGGCCGATCCGGAACT -> CGTTCAGAGGCCGATCCGGAACTT
TTCAGATCGCCTCACTTAGTCGAC -> TCAGATCGCCTCACTTAGTCGACT
GATAGATAATGGTCTCAGACATAT -> ATAGATAATGGTCTCAGACATATT
TTGTTGTGACACAGGAAGCAGCCA -> TGTTGTGACACAGGAAGCAGCCAG
CCTTCGTAGTGGGCGATGCTATGT -> CTTCGTAGTGGGCGATGCTATGTG
AATGGAGGTTGCGGAGCGAGTCCT -> ATGGAGGTTGCGGAGCGAGTCCTC
ATAATAGTCGCTTCTAATGGGCTC -> TAATAGTCGCTTCTAATGGGCTCT
TGCTAGGACGTCTATCAGGAAGTG -> GCTAGGACGTCTATCAGGAAGTGT
ACGAAACCGAAGTGGTAAATTAAA -> CGAAACCGAAGTGGTAAATTAAAG
TTCAATACATACGGGTGGTCACTC -> TCAATACATACGGGTGGTCACTCC
CCGCGTAGGCGCGAGCGGAGACTG -> CGCGTAGGCGCGAGCGGAGACTGC
TGCATGACGGGTGCGGATGAAATA -> GCATGACGGGTGCGGATGAAATAT
CCGTGGGGCGTGACCGTACCGAAA -> CGTGGGGCGTGACCGTACCGAAAG
GGGGACTACGTCACGTAGTCACTT -> GGGACTACGTCACGTAGTCACTTG
CGAAGCGACGCTCTTTTCGAGGGG -> GAAGCGACGCTCTTTTCGAGGGGC
AAGTGGCATAATACCGCACAATCT -> AGTGGCATAATACCGCACAATCTT
CATATTGGACATTTCCTAATAACT -> ATATTGGACATTTCCTAATAACTG
ATGCATGACGGGTGCGGATGAAAT -> TGCATGACGGGTGCGGATGAAATA
TCGAAGCGACGCTCTTTTCGAGGG -> CGAAGCGACGCTCTTTTCGAGGGG
GTATGCATGACGGGTGCGGATGAA -> TATGCATGACGGGTGCGGATGAAA
ACTCTATGTACAAGTAACGGATGC -> CTCTATGTACAAGTAACGGATGCT
GACCGTACCGAAAGTCAAGAATGT -> ACCGTACCGAAAGTCAAGAATGTA
ATAGGGGACAGTTGAAAGCGTGCG -> TAGGGGACAGTTGAAAGCGTGCGT
TCCCTATTTGTTGTGACACAGGAA -> CCCTATTTGTTGTGACACAGGAAG
CTGGCCGCCTACCGGGGTATGGGT -> TGGCCGCCTACCGGGGTATGGGTG
TCAGCGTAGAGGCCTCAACGTTCT -> CAGCGTAGAGGCCTCAACGTTCTG
GATGGCCCTCACAAGAACCGTTAT -> ATGGCCCTCACAAGAACCGTTATC
CAACCGGAACCAGACTGGTACATC -> AACCGGAACCAGACTGGTACATCG
CTCCTTCGTAGTGGGCGATGCTAT -> TCCTTCGTAGTGGGCGATGCTATG
TTCGAAGCGACGCTCTTTTCGAGG -> TCGAAGCGACGCTCTTTTCGAGGG
TCAACCGGAACCAGACTGGTACAT -> CAACCGGAACCAGACTGGTACATC
TTACCAACTCAATCTAGGCGTTAC -> TACCAACTCAATCTAGGCGTTACG
CACCTACGTACGAGACGCTGCCCT -> ACCTACGTACGAGACGCTGCCCTG
GAACGCTTACCAACTCAATCTAGG -> AACGCTTACCAACTCAATCTAGGC
GGCGTGACCGTACCGAAAGTCAAG -> GCGTGACCGTACCGAAAGTCAAGA
GATTCCCCCGGACGGTAACCGATG -> ATTCCCCCGGACGGTAACCGATGG
ATTCAGCGTTGTGTATGCATGACG -> TTCAGCGTTGTGTATGCATGACGG
TCTGTTCGAAGCGACGCTCTTTTC -> CTGTTCGAAGCGACGCTCTTTTCG
TGAAATGCTAGGACGTCTATCAGG -> GAAATGCTAGGACGTCTATCAGGA
TTCCGATCTCTTAAGGTGCGACGG -> TCCGATCTCTTAAGGTGCGACGGG
GCCCACTCCCCGCTTCAGATCGCC -> CCCACTCCCCGCTTCAGATCGCCT
TTGGTGCCCACTCCCCGCTTCAGA -> TGGTGCCCACTCCCCGCTTCAGAT
ATCTCTTAAGGTGCGACGGGGACT -> TCTCTTAAGGTGCGACGGGGACTA
AAAGCGTGCGTTGGGAACGATACT -> AAGCGTGCGTTGGGAACGATACTC
TTGTCGATAGTTGTTTCCGCAAGG -> TGTCGATAGTTGTTTCCGCAAGGC
AAAAAATAGCGGGAGATGAATAGG -> AAAAATAGCGGGAGATGAATAGGG
ATCCATCTGGATGGCACCTACGTA -> TCCATCTGGATGGCACCTACGTAC
ACTCAACCGGAACCAGACTGGTAC -> CTCAACCGGAACCAGACTGGTACA
GCAGCTGACTCATCTTGAATCCTA -> CAGCTGACTCATCTTGAATCCTAT
CGGAACTCGTTCCGATCTCTTAAG -> GGAACTCGTTCCGATCTCTTAAGG
GATGAGGTTTGCCACACGAAACCG -> ATGAGGTTTGCCACACGAAACCGA
CAGCTTGCCCTGTTTACTTCGTTC -> AGCTTGCCCTGTTTACTTCGTTCG
AGAAATGACCCCGCACCTGAAGCT -> GAAATGACCCCGCACCTGAAGCTA
GTCCGGTTGACAATGCATTTGATC -> TCCGGTTGACAATGCATTTGATCG
GCATGACGGGTGCGGATGAAATAT -> CATGACGGGTGCGGATGAAATATG
AGTTTTTGTCGATAGTTGTTTCCG -> GTTTTTGTCGATAGTTGTTTCCGC
AATGGGCTCTGGATAGTGTATTTC -> ATGGGCTCTGGATAGTGTATTTCA
AGCCCAGCTTGCCCTGTTTACTTC -> GCCCAGCTTGCCCTGTTTACTTCG
CGTACCGAAAGTCAAGAATGTAAT -> GTACCGAAAGTCAAGAATGTAATG
GTTGATTCCCCCGGACGGTAACCG -> TTGATTCCCCCGGACGGTAACCGA
CGCCACCTAGTCACCGGCACTTCA -> GCCACCTAGTCACCGGCACTTCAT
TCCTATTTAGTTCAATACATACGG -> CCTATTTAGTTCAATACATACGGG
TAATGGTCTCAGACATATTGGACA -> AATGGTCTCAGACATATTGGACAT
AGTGGCATAATACCGCACAATCTT -> GTGGCATAATACCGCACAATCTTA
CTCTCACGAGACGTGTGGTGTGAG -> TCTCACGAGACGTGTGGTGTGAGC
TAGGGGACAGTTGAAAGCGTGCGT -> AGGGGACAGTTGAAAGCGTGCGTT
TTGGATGCGGCTGAAACTGAATGG -> TGGATGCGGCTGAAACTGAATGGT
GGCTCTGGATAGTGTATTTCAGGC -> GCTCTGGATAGTGTATTTCAGGCC
CTGCCGGAACTCGTTCCGATCTCT -> TGCCGGAACTCGTTCCGATCTCTT
AAATAGCGGGAGATGAATAGGGGA -> AATAGCGGGAGATGAATAGGGGAC
TAGTGTATTTCAGGCCGAGGTTGA -> AGTGTATTTCAGGCCGAGGTTGAT
ACGATACTCAGTTGGATGCGGCTG -> CGATACTCAGTTGGATGCGGCTGA
TGACAATGCATTTGATCGTCATAA -> GACAATGCATTTGATCGTCATAAG
GATCGCCTCACTTAGTCGACTGAG -> ATCGCCTCACTTAGTCGACTGAGC
AGAGGCAGTCCGGTTGACAATGCA -> GAGGCAGTCCGGTTGACAATGCAT
CCACCTAGTCACCGGCACTTCATC -> CACCTAGTCACCGGCACTTCATCA
GGAACTTACATGAATTCGCGATAA -> GAACTTACATGAATTCGCGATAAT
GGGTGGTCACTCCTTATGTACCCA -> GGTGGTCACTCCTTATGTACCCAC
GGCAGCTGACTCATCTTGAATCCT -> GCAGCTGACTCATCTTGAATCCTA
CTTACCAACTCAATCTAGGCGTTA -> TTACCAACTCAATCTAGGCGTTAC
TCTCGGTATGAACCTCCCCTCATA -> CTCGGTATGAACCTCCCCTCATAA
CCTAGTCACCGGCACTTCATCAAT -> CTAGTCACCGGCACTTCATCAATT
GCCCTGTTTACTTCGTTCGGCAGC -> CCCTGTTTACTTCGTTCGGCAGCT
TACCGGGGTATGGGTGAAGAATGG -> ACCGGGGTATGGGTGAAGAATGGA
ACCCCGGATTCAATAAAGCCCAGC -> CCCCGGATTCAATAAAGCCCAGCT
ACGCTGCCCTGCGCTCTCACGAGA -> CGCTGCCCTGCGCTCTCACGAGAC
CAGCGATCAATGTTAATGCATGGA -> AGCGATCAATGTTAATGCATGGAA
CCAGCGATGCAACAACTGCTAACG -> CAGCGATGCAACAACTGCTAACGA
TGAACAGTCGATATCCATCTGGAT -> GAACAGTCGATATCCATCTGGATG
GACTGCCGGAACTCGTTCCGATCT -> ACTGCCGGAACTCGTTCCGATCTC
GTGCGACGGGGACTACGTCACGTA -> TGCGACGGGGACTACGTCACGTAG
ATGGCCTGCGTCAGAGGCAGTCCG -> TGGCCTGCGTCAGAGGCAGTCCGG
GAATTCGCGATAATAGTCAAATCG -> AATTCGCGATAATAGTCAAATCGA
AGTGCTCGGAACTCTATGTACAAG -> GTGCTCGGAACTCTATGTACAAGT
ATTGGACATTTCCTAATAACTGCT -> TTGGACATTTCCTAATAACTGCTC
TTCTAATGGGCTCTGGATAGTGTA -> TCTAATGGGCTCTGGATAGTGTAT
TCAGCGATCAATGTTAATGCATGG -> CAGCGATCAATGTTAATGCATGGA
ACTGATGTCCATGTCCGAGGCACC -> CTGATGTCCATGTCCGAGGCACCC
GATCCGGAACTTACATGAATTCGC -> ATCCGGAACTTACATGAATTCGCG
CTGTCCGGGTGGTCGCCGATGACT -> TGTCCGGGTGGTCGCCGATGACTT
TCGTTCCGATCTCTTAAGGTGCGA -> CGTTCCGATCTCTTAAGGTGCGAC
CGCTTACCAACTCAATCTAGGCGT -> GCTTACCAACTCAATCTAGGCGTT
AGTGGGCGATGCTATGTGATTGTC -> GTGGGCGATGCTATGTGATTGTCT
ACCTCATCCCGATGGCCCTCACAA -> CCTCATCCCGATGGCCCTCACAAG
GCACCGTTAAGTTTTTGTCGATAG -> CACCGTTAAGTTTTTGTCGATAGT
GGCAGCTACAGTTTACTTACCTCG -> GCAGCTACAGTTTACTTACCTCGA
AGAATCAGCGTAGAGGCCTCAACG -> GAATCAGCGTAGAGGCCTCAACGT
TGCGGATGAAATATGTCAGCACCG -> GCGGATGAAATATGTCAGCACCGC
ACAGTCGATATCCATCTGGATGGC -> CAGTCGATATCCATCTGGATGGCA
GATGCATAGAAATGACCCCGCACC -> ATGCATAGAAATGACCCCGCACCT
TACAAGTAACGGATGCTGGCCGCC -> ACAAGTAACGGATGCTGGCCGCCT
GTGCTCGGAACTCTATGTACAAGT -> TGCTCGGAACTCTATGTACAAGTA
ATGTCAGCACCGCGTAGGCGCGAG -> TGTCAGCACCGCGTAGGCGCGAGC
TAATACCGCACAATCTTATAATAG -> AATACCGCACAATCTTATAATAGT
GTGACCGTACCGAAAGTCAAGAAT -> TGACCGTACCGAAAGTCAAGAATG
CCTCATCCCGATGGCCCTCACAAG -> CTCATCCCGATGGCCCTCACAAGA
CTGTTCGAAGCGACGCTCTTTTCG -> TGTTCGAAGCGACGCTCTTTTCGA
CATCTGGATGGCACCTACGTACGA -> ATCTGGATGGCACCTACGTACGAG
AACGTTCTGCCAGATCTTGATGCA -> ACGTTCTGCCAGATCTTGATGCAT
CTACGTACGAGACGCTGCCCTGCG -> TACGTACGAGACGCTGCCCTGCGC
TACCAACTCAATCTAGGCGTTACG -> ACCAACTCAATCTAGGCGTTACGT
AACCTCAGGAAATTTTTGTCTGTT -> ACCTCAGGAAATTTTTGTCTGTTC
AAATTAAAGGCTTCCCGAAGGGGA -> AATTAAAGGCTTCCCGAAGGGGAA
AGTGGTAAATTAAAGGCTTCCCGA -> GTGGTAAATTAAAGGCTTCCCGAA
GTGTGGTGTGAGCAGTTAATAGAA -> TGTGGTGTGAGCAGTTAATAGAAG
GTTCAGAGGCCGATCCGGAACTTA -> TTCAGAGGCCGATCCGGAACTTAC
TCCATGTCCGAGGCACCCCGGATT -> CCATGTCCGAGGCACCCCGGATTC
TCAGTTGGATGCGGCTGAAACTGA -> CAGTTGGATGCGGCTGAAACTGAA
GCGCTCTCACGAGACGTGTGGTGT -> CGCTCTCACGAGACGTGTGGTGTG
AATAGAAGTACCCCCTCCTTCGTA -> ATAGAAGTACCCCCTCCTTCGTAG
ATAATGGTCTCAGACATATTGGAC -> TAATGGTCTCAGACATATTGGACA
CCGGGTGGTCGCCGATGACTTCGC -> CGGGTGGTCGCCGATGACTTCGCC
AAGCCATCAGAATCAGCGTAGAGG -> AGCCATCAGAATCAGCGTAGAGGC
ACTCAGTTGGATGCGGCTGAAACT -> CTCAGTTGGATGCGGCTGAAACTG
CGGACGGTAACCGATGGCCAGCGA -> GGACGGTAACCGATGGCCAGCGAT
CGGATGCTGGCCGCCTACCGGGGT -> GGATGCTGGCCGCCTACCGGGGTA
CAGAACTTTGTTACCCGACGTGCC -> AGAACTTTGTTACCCGACGTGCCT
CTGCGTCAGAGGCAGTCCGGTTGA -> TGCGTCAGAGGCAGTCCGGTTGAC
GCTTGCCCTGTTTACTTCGTTCGG -> CTTGCCCTGTTTACTTCGTTCGGC
TGGCCTGCGTCAGAGGCAGTCCGG -> GGCCTGCGTCAGAGGCAGTCCGGT
CCTTGGTGCCCACTCCCCGCTTCA -> CTTGGTGCCCACTCCCCGCTTCAG
GCGGATGAAATATGTCAGCACCGC -> CGGATGAAATATGTCAGCACCGCG
TTACTTCGTTCGGCAGCTGACTCA -> TACTTCGTTCGGCAGCTGACTCAT
TCAATACATACGGGTGGTCACTCC -> CAATACATACGGGTGGTCACTCCT
CTGGTACATCGGAAAGATGAGGGT -> TGGTACATCGGAAAGATGAGGGTA
CAATCTAGGCGTTACGTTCAGAGG -> AATCTAGGCGTTACGTTCAGAGGC
TACCTTGGTGCCCACTCCCCGCTT -> ACCTTGGTGCCCACTCCCCGCTTC
TCTGTTCATTCTAACACAGAGGTA -> CTGTTCATTCTAACACAGAGGTAC
ACTCCTTATGTACCCACCTTGGTG -> CTCCTTATGTACCCACCTTGGTGC
CCCACTCCCCGCTTCAGATCGCCT -> CCACTCCCCGCTTCAGATCGCCTC
ACGGCTACGGTATAGTGCTCGGAA -> CGGCTACGGTATAGTGCTCGGAAC
AGCGATCAATGTTAATGCATGGAA -> GCGATCAATGTTAATGCATGGAAT
CCGGACGGTAACCGATGGCCAGCG -> CGGACGGTAACCGATGGCCAGCGA
CATAATACCGCACAATCTTATAAT -> ATAATACCGCACAATCTTATAATA
TGCTCTTTACCTTGGTGCCCACTC -> GCTCTTTACCTTGGTGCCCACTCC
ATTCTAACACAGAGGTACAGAACT -> TTCTAACACAGAGGTACAGAACTT
GAGGCACCCCGGATTCAATAAAGC -> AGGCACCCCGGATTCAATAAAGCC
ACTTCATCAATTCAGCGTTGTGTA -> CTTCATCAATTCAGCGTTGTGTAT
TACCGAAAGTCAAGAATGTAATGG -> ACCGAAAGTCAAGAATGTAATGGC
ATAGTGTATTTCAGGCCGAGGTTG -> TAGTGTATTTCAGGCCGAGGTTGA
AACAACTGCTAACGAACGCTTACC -> ACAACTGCTAACGAACGCTTACCA
GCTTACCAACTCAATCTAGGCGTT -> CTTACCAACTCAATCTAGGCGTTA
GGTATGAACCTCCCCTCATAAGCC -> GTATGAACCTCCCCTCATAAGCCG
TCCTTATGTACCCACCTTGGTGCG -> CCTTATGTACCCACCTTGGTGCGC
GCTCTTTTCGAGGGGCACCGTTAA -> CTCTTTTCGAGGGGCACCGTTAAG
CCTCCTTCGTAGTGGGCGATGCTA -> CTCCTTCGTAGTGGGCGATGCTAT
CGTGTGGTGTGAGCAGTTAATAGA -> GTGTGGTGTGAGCAGTTAATAGAA
ATCAATTCAGCGTTGTGTATGCAT -> TCAATTCAGCGTTGTGTATGCATG
TTCGTAGTGGGCGATGCTATGTGA -> TCGTAGTGGGCGATGCTATGTGAT
ACGTCTATCAGGAAGTGTGCTGTC -> CGTCTATCAGGAAGTGTGCTGTCC
CAACTCAATCTAGGCGTTACGTTC -> AACTCAATCTAGGCGTTACGTTCA
TCCTAATAACTGCTCTTTACCTTG -> CCTAATAACTGCTCTTTACCTTGG
GCAGTCCGGTTGACAATGCATTTG -> CAGTCCGGTTGACAATGCATTTGA
CCAGATCTTGATGCATAGAAATGA -> CAGATCTTGATGCATAGAAATGAC
GGCACCTACGTACGAGACGCTGCC -> GCACCTACGTACGAGACGCTGCCC
GGTATGGGTGAAGAATGGAGGTTG -> GTATGGGTGAAGAATGGAGGTTGC
ACCTCCCCTCATAAGCCGCCTCAA -> CCTCCCCTCATAAGCCGCCTCAAT
TCAACGTTCTGCCAGATCTTGATG -> CAACGTTCTGCCAGATCTTGATGC
CCGCACAATCTTATAATAGTCGCT -> CGCACAATCTTATAATAGTCGCTT
AAGTTTTTGTCGATAGTTGTTTCC -> AGTTTTTGTCGATAGTTGTTTCCG
TGAGGTTTGCCACACGAAACCGAA -> GAGGTTTGCCACACGAAACCGAAG
TATGTACCCACCTTGGTGCGCACA -> ATGTACCCACCTTGGTGCGCACAA
CGGCACTTCATCAATTCAGCGTTG -> GGCACTTCATCAATTCAGCGTTGT
CAATGCATTTGATCGTCATAAGCC -> AATGCATTTGATCGTCATAAGCCA
GCGATGCAACAACTGCTAACGAAC -> CGATGCAACAACTGCTAACGAACG
CGCCTACCGGGGTATGGGTGAAGA -> GCCTACCGGGGTATGGGTGAAGAA
AAGTGGTAAATTAAAGGCTTCCCG -> AGTGGTAAATTAAAGGCTTCCCGA
CAATTCAGCGTTGTGTATGCATGA -> AATTCAGCGTTGTGTATGCATGAC
TAACACAGAGGTACAGAACTTTGT -> AACACAGAGGTACAGAACTTTGTT
CACCTTGGTGCGCACAAACGGCTA -> ACCTTGGTGCGCACAAACGGCTAC
GAACTTTGTTACCCGACGTGCCTA -> AACTTTGTTACCCGACGTGCCTAT
GAAATATGTCAGCACCGCGTAGGC -> AAATATGTCAGCACCGCGTAGGCG
TCACCGGCACTTCATCAATTCAGC -> CACCGGCACTTCATCAATTCAGCG
TATGTCAGCACCGCGTAGGCGCGA -> ATGTCAGCACCGCGTAGGCGCGAG
CAGATGCATCTCGGTATGAACCTC -> AGATGCATCTCGGTATGAACCTCC
AGTCCGGTTGACAATGCATTTGAT -> GTCCGGTTGACAATGCATTTGATC
GCCTCAACGTTCTGCCAGATCTTG -> CCTCAACGTTCTGCCAGATCTTGA
GATTGTCTCGGCAGGATGAGGTTT -> ATTGTCTCGGCAGGATGAGGTTTG
AAGTCAAGAATGTAATGGCCTGCG -> AGTCAAGAATGTAATGGCCTGCGT
TTGTTTCCGCAAGGCAGCTACAGT -> TGTTTCCGCAAGGCAGCTACAGTT
GACTACGTCACGTAGTCACTTGAT -> ACTACGTCACGTAGTCACTTGATC
CGAAGTGGTAAATTAAAGGCTTCC -> GAAGTGGTAAATTAAAGGCTTCCC
ATCCGGAACTTACATGAATTCGCG -> TCCGGAACTTACATGAATTCGCGA
TTACCTTGGTGCCCACTCCCCGCT -> TACCTTGGTGCCCACTCCCCGCTT
CGGATGAAATATGTCAGCACCGCG -> GGATGAAATATGTCAGCACCGCGT
CTATTTAGTTCAATACATACGGGT -> TATTTAGTTCAATACATACGGGTG
GAGCGAGTCCTCTGTTCATTCTAA -> AGCGAGTCCTCTGTTCATTCTAAC
AACCGTTATCTGTCCGGGTGGTCG -> ACCGTTATCTGTCCGGGTGGTCGC
CGTTAAGTTTTTGTCGATAGTTGT -> GTTAAGTTTTTGTCGATAGTTGTT
TATTTGTTGTGACACAGGAAGCAG -> ATTTGTTGTGACACAGGAAGCAGC
TAACGAACGCTTACCAACTCAATC -> AACGAACGCTTACCAACTCAATCT
ACACAGAGGTACAGAACTTTGTTA -> CACAGAGGTACAGAACTTTGTTAC
GCCAGCGATGCAACAACTGCTAAC -> CCAGCGATGCAACAACTGCTAACG
GAAACTGAATGGTAACGGCTGACA -> AAACTGAATGGTAACGGCTGACAT
AGTCACCGGCACTTCATCAATTCA -> GTCACCGGCACTTCATCAATTCAG
AAGGTGCGACGGGGACTACGTCAC -> AGGTGCGACGGGGACTACGTCACG
TCTTTACCTTGGTGCCCACTCCCC -> CTTTACCTTGGTGCCCACTCCCCG
AACGGCTGACATCTGAACAGTCGA -> ACGGCTGACATCTGAACAGTCGAT
TTACCCGACGTGCCTATAAAATTA -> TACCCGACGTGCCTATAAAATTAC
TTAGTTCAATACATACGGGTGGTC -> TAGTTCAATACATACGGGTGGTCA
ACTGGTACATCGGAAAGATGAGGG -> CTGGTACATCGGAAAGATGAGGGT
CGGTTGACAATGCATTTGATCGTC -> GGTTGACAATGCATTTGATCGTCA
GAATAGGGGACAGTTGAAAGCGTG -> AATAGGGGACAGTTGAAAGCGTGC
ACTTCGCCACCTAGTCACCGGCAC -> CTTCGCCACCTAGTCACCGGCACT
TCAATAAAGCCCAGCTTGCCCTGT -> CAATAAAGCCCAGCTTGCCCTGTT
ATAGTGCTCGGAACTCTATGTACA -> TAGTGCTCGGAACTCTATGTACAA
GAAGAATGGAGGTTGCGGAGCGAG -> AAGAATGGAGGTTGCGGAGCGAGT
TTCGCGATAATAGTCAAATCGAGC -> TCGCGATAATAGTCAAATCGAGCA
GCAAGGCAGCTACAGTTTACTTAC -> CAAGGCAGCTACAGTTTACTTACC
GTTAATAGAAGTACCCCCTCCTTC -> TTAATAGAAGTACCCCCTCCTTCG
GAACAGTCGATATCCATCTGGATG -> AACAGTCGATATCCATCTGGATGG
GCTGGCCGCCTACCGGGGTATGGG -> CTGGCCGCCTACCGGGGTATGGGT
ACATCTGAACAGTCGATATCCATC -> CATCTGAACAGTCGATATCCATCT
CTGATGTCCATGTCCGAGGCACCC -> TGATGTCCATGTCCGAGGCACCCC
CTCTTAAGGTGCGACGGGGACTAC -> TCTTAAGGTGCGACGGGGACTACG
ATCCCGATGGCCCTCACAAGAACC -> TCCCGATGGCCCTCACAAGAACCG
TTCCGCAAGGCAGCTACAGTTTAC -> TCCGCAAGGCAGCTACAGTTTACT
GCCTGCGTCAGAGGCAGTCCGGTT -> CCTGCGTCAGAGGCAGTCCGGTTG
TTTACCTTGGTGCCCACTCCCCGC -> TTACCTTGGTGCCCACTCCCCGCT
TGATAGATAATGGTCTCAGACATA -> GATAGATAATGGTCTCAGACATAT
TGCGACGGGGACTACGTCACGTAG -> GCGACGGGGACTACGTCACGTAGT
GTGGTCGCCGATGACTTCGCCACC -> TGGTCGCCGATGACTTCGCCACCT
GGGGACAGTTGAAAGCGTGCGTTG -> GGGACAGTTGAAAGCGTGCGTTGG
GCTCTTTACCTTGGTGCCCACTCC -> CTCTTTACCTTGGTGCCCACTCCC
AGACGCTGCCCTGCGCTCTCACGA -> GACGCTGCCCTGCGCTCTCACGAG
ACCCACCTTGGTGCGCACAAACGG -> CCCACCTTGGTGCGCACAAACGGC
ATAATACCGCACAATCTTATAATA -> TAATACCGCACAATCTTATAATAG
CCATCTGGATGGCACCTACGTACG -> CATCTGGATGGCACCTACGTACGA
GGCCAGCGATGCAACAACTGCTAA -> GCCAGCGATGCAACAACTGCTAAC
CGGTATGAACCTCCCCTCATAAGC -> GGTATGAACCTCCCCTCATAAGCC
ATAGCGGGAGATGAATAGGGGACA -> TAGCGGGAGATGAATAGGGGACAG
ACTCATCTTGAATCCTATTTAGTT -> CTCATCTTGAATCCTATTTAGTTC
AAGATGAGGGTACCTCATCCCGAT -> AGATGAGGGTACCTCATCCCGATG
GAGGTTTGCCACACGAAACCGAAG -> AGGTTTGCCACACGAAACCGAAGT
CCTGCGTCAGAGGCAGTCCGGTTG -> CTGCGTCAGAGGCAGTCCGGTTGA
CTTGGTGCGCACAAACGGCTACGG -> TTGGTGCGCACAAACGGCTACGGT
TTAAGTTTTTGTCGATAGTTGTTT -> TAAGTTTTTGTCGATAGTTGTTTC
CCCGGATTCAATAAAGCCCAGCTT -> CCGGATTCAATAAAGCCCAGCTTG
ACTGCCGGAACTCGTTCCGATCTC -> CTGCCGGAACTCGTTCCGATCTCT
CACCCCGGATTCAATAAAGCCCAG -> ACCCCGGATTCAATAAAGCCCAGC
ACGCTCTTTTCGAGGGGCACCGTT -> CGCTCTTTTCGAGGGGCACCGTTA
GTCAGAGGCAGTCCGGTTGACAAT -> TCAGAGGCAGTCCGGTTGACAATG
CGGGTGGTCGCCGATGACTTCGCC -> GGGTGGTCGCCGATGACTTCGCCA
ATACCGCACAATCTTATAATAGTC -> TACCGCACAATCTTATAATAGTCG
TCAGAATCAGCGTAGAGGCCTCAA -> CAGAATCAGCGTAGAGGCCTCAAC
ACCGTACCGAAAGTCAAGAATGTA -> CCGTACCGAAAGTCAAGAATGTAA
ATAAAGCCCAGCTTGCCCTGTTTA -> TAAAGCCCAGCTTGCCCTGTTTAC
TGCGCACAAACGGCTACGGTATAG -> GCGCACAAACGGCTACGGTATAGT
AATGCATTTGATCGTCATAAGCCA -> ATGCATTTGATCGTCATAAGCCAT
GTAACGGCTGACATCTGAACAGTC -> TAACGGCTGACATCTGAACAGTCG
GAGGTTGCGGAGCGAGTCCTCTGT -> AGGTTGCGGAGCGAGTCCTCTGTT
CCGTTATCTGTCCGGGTGGTCGCC -> CGTTATCTGTCCGGGTGGTCGCCG
TACTGATGTCCATGTCCGAGGCAC -> ACTGATGTCCATGTCCGAGGCACC
ACGGATGCTGGCCGCCTACCGGGG -> CGGATGCTGGCCGCCTACCGGGGT
GGGTGCGGATGAAATATGTCAGCA -> GGTGCGGATGAAATATGTCAGCAC
CGCTGCCCTGCGCTCTCACGAGAC -> GCTGCCCTGCGCTCTCACGAGACG
GGACAGTTGAAAGCGTGCGTTGGG -> GACAGTTGAAAGCGTGCGTTGGGA
TCATTCTAACACAGAGGTACAGAA -> CATTCTAACACAGAGGTACAGAAC
AATGTAATGGCCTGCGTCAGAGGC -> ATGTAATGGCCTGCGTCAGAGGCA
GTCTATCAGGAAGTGTGCTGTCCC -> TCTATCAGGAAGTGTGCTGTCCCT
GCGTTACGTTCAGAGGCCGATCCG -> CGTTACGTTCAGAGGCCGATCCGG
TCTCGGCAGGATGAGGTTTGCCAC -> CTCGGCAGGATGAGGTTTGCCACA
ATGAATAGGGGACAGTTGAAAGCG -> TGAATAGGGGACAGTTGAAAGCGT
TGCTGTCCCTATTTGTTGTGACAC -> GCTGTCCCTATTTGTTGTGACACA
CTGCTCTTTACCTTGGTGCCCACT -> TGCTCTTTACCTTGGTGCCCACTC
AACTGCTAACGAACGCTTACCAAC -> ACTGCTAACGAACGCTTACCAACT
ACGGTAACCGATGGCCAGCGATGC -> CGGTAACCGATGGCCAGCGATGCA
TGGGGCGTGACCGTACCGAAAGTC -> GGGGCGTGACCGTACCGAAAGTCA
TGAAGCTATACAGGCGTATTAACT -> GAAGCTATACAGGCGTATTAACTT
TGGTGCCCACTCCCCGCTTCAGAT -> GGTGCCCACTCCCCGCTTCAGATC
TGGATGCGGCTGAAACTGAATGGT -> GGATGCGGCTGAAACTGAATGGTA
TGTATGCATGACGGGTGCGGATGA -> GTATGCATGACGGGTGCGGATGAA
TCACTCCTTATGTACCCACCTTGG -> CACTCCTTATGTACCCACCTTGGT
GGCCGAGGTTGATTCCCCCGGACG -> GCCGAGGTTGATTCCCCCGGACGG
GCAAGTGGCATAATACCGCACAAT -> CAAGTGGCATAATACCGCACAATC
GCTGTCCCTATTTGTTGTGACACA -> CTGTCCCTATTTGTTGTGACACAG
GTTAAGTTTTTGTCGATAGTTGTT -> TTAAGTTTTTGTCGATAGTTGTTT
CTCTTTTCGAGGGGCACCGTTAAG -> TCTTTTCGAGGGGCACCGTTAAGT
TCGGCAGGATGAGGTTTGCCACAC -> CGGCAGGATGAGGTTTGCCACACG
GTCGCTTCTAATGGGCTCTGGATA -> TCGCTTCTAATGGGCTCTGGATAG
CTCTATGTACAAGTAACGGATGCT -> TCTATGTACAAGTAACGGATGCTG
CCTGCGCTCTCACGAGACGTGTGG -> CTGCGCTCTCACGAGACGTGTGGT
ATGACTTCGCCACCTAGTCACCGG -> TGACTTCGCCACCTAGTCACCGGC
TCTGCCAGATCTTGATGCATAGAA -> CTGCCAGATCTTGATGCATAGAAA
CATGGAATAAAAAAAAATAGCGGG -> ATGGAATAAAAAAAAATAGCGGGA
AAAATTACTGATAGATAATGGTCT -> AAATTACTGATAGATAATGGTCTC
ATGCATCTCGGTATGAACCTCCCC -> TGCATCTCGGTATGAACCTCCCCT
CCTATAAAATTACTGATAGATAAT -> CTATAAAATTACTGATAGATAATG
CGTTATCTGTCCGGGTGGTCGCCG -> GTTATCTGTCCGGGTGGTCGCCGA
TGGTACATCGGAAAGATGAGGGTA -> GGTACATCGGAAAGATGAGGGTAC
GTACAGAACTTTGTTACCCGACGT -> TACAGAACTTTGTTACCCGACGTG
CCCACCTTGGTGCGCACAAACGGC -> CCACCTTGGTGCGCACAAACGGCT
TACTTACCTCGACAGCTCGGGGCA -> ACTTACCTCGACAGCTCGGGGCAA
AAGGGGAACCTCAGGAAATTTTTG -> AGGGGAACCTCAGGAAATTTTTGT
TCACAAGAACCGTTATCTGTCCGG -> CACAAGAACCGTTATCTGTCCGGG
AGACGTGTGGTGTGAGCAGTTAAT -> GACGTGTGGTGTGAGCAGTTAATA
AGTGTATTTCAGGCCGAGGTTGAT -> GTGTATTTCAGGCCGAGGTTGATT
CCGAAGGGGAACCTCAGGAAATTT -> CGAAGGGGAACCTCAGGAAATTTT
ACCCCCTCCTTCGTAGTGGGCGAT -> CCCCCTCCTTCGTAGTGGGCGATG
GCAGCCAGATGCATCTCGGTATGA -> CAGCCAGATGCATCTCGGTATGAA
TTGTCTCGGCAGGATGAGGTTTGC -> TGTCTCGGCAGGATGAGGTTTGCC
TGTAATGGCCTGCGTCAGAGGCAG -> GTAATGGCCTGCGTCAGAGGCAGT
GAGCATTGAAATGCTAGGACGTCT -> AGCATTGAAATGCTAGGACGTCTA
CCAGACTGGTACATCGGAAAGATG -> CAGACTGGTACATCGGAAAGATGA
CGACTGAGCGGGATATAGTACCGT -> GACTGAGCGGGATATAGTACCGTG
TAGTGCTCGGAACTCTATGTACAA -> AGTGCTCGGAACTCTATGTACAAG
TATAATAGTCGCTTCTAATGGGCT -> ATAATAGTCGCTTCTAATGGGCTC
TAAGCCATCAGAATCAGCGTAGAG -> AAGCCATCAGAATCAGCGTAGAGG
CACTTAGTCGACTGAGCGGGATAT -> ACTTAGTCGACTGAGCGGGATATA
ACCGCACAATCTTATAATAGTCGC -> CCGCACAATCTTATAATAGTCGCT
TAAAGGCTTCCCGAAGGGGAACCT -> AAAGGCTTCCCGAAGGGGAACCTC
GACATATTGGACATTTCCTAATAA -> ACATATTGGACATTTCCTAATAAC
AATCGAGCATTGAAATGCTAGGAC -> ATCGAGCATTGAAATGCTAGGACG
TCTGAACAGTCGATATCCATCTGG -> CTGAACAGTCGATATCCATCTGGA
GCGAGCGGAGACTGCCGGAACTCG -> CGAGCGGAGACTGCCGGAACTCGT
ATACGGGTGGTCACTCCTTATGTA -> TACGGGTGGTCACTCCTTATGTAC
TAAGGTGCGACGGGGACTACGTCA -> AAGGTGCGACGGGGACTACGTCAC
CTAACGAACGCTTACCAACTCAAT -> TAACGAACGCTTACCAACTCAATC
TGGTCACTCCTTATGTACCCACCT -> GGTCACTCCTTATGTACCCACCTT
CCAGCTTGCCCTGTTTACTTCGTT -> CAGCTTGCCCTGTTTACTTCGTTC
TTGGGAACGATACTCAGTTGGATG -> TGGGAACGATACTCAGTTGGATGC
CTCGACAGCTCGGGGCAAGTGGCA -> TCGACAGCTCGGGGCAAGTGGCAT
CAGGAAGCAGCCAGATGCATCTCG -> AGGAAGCAGCCAGATGCATCTCGG
GTCAAGAATGTAATGGCCTGCGTC -> TCAAGAATGTAATGGCCTGCGTCA
ATCTAGGCGTTACGTTCAGAGGCC -> TCTAGGCGTTACGTTCAGAGGCCG
TGGTGCGCACAAACGGCTACGGTA -> GGTGCGCACAAACGGCTACGGTAT
TATGGGTGAAGAATGGAGGTTGCG -> ATGGGTGAAGAATGGAGGTTGCGG
TATACAGGCGTATTAACTTGACTC -> ATACAGGCGTATTAACTTGACTCA
GGGAACGATACTCAGTTGGATGCG -> GGAACGATACTCAGTTGGATGCGG
GCTGACATCTGAACAGTCGATATC -> CTGACATCTGAACAGTCGATATCC
CTGATAGATAATGGTCTCAGACAT -> TGATAGATAATGGTCTCAGACATA
CCTGAAGCTATACAGGCGTATTAA -> CTGAAGCTATACAGGCGTATTAAC
TCAGCGTTGTGTATGCATGACGGG -> CAGCGTTGTGTATGCATGACGGGT
GCATGGAATAAAAAAAAATAGCGG -> CATGGAATAAAAAAAAATAGCGGG
TTCATCAATTCAGCGTTGTGTATG -> TCATCAATTCAGCGTTGTGTATGC
ACCTACGTACGAGACGCTGCCCTG -> CCTACGTACGAGACGCTGCCCTGC
CCGAGGTTGATTCCCCCGGACGGT -> CGAGGTTGATTCCCCCGGACGGTA
CTCAATCTAGGCGTTACGTTCAGA -> TCAATCTAGGCGTTACGTTCAGAG
AGCGGGAGATGAATAGGGGACAGT -> GCGGGAGATGAATAGGGGACAGTT
GTGCGTTGGGAACGATACTCAGTT -> TGCGTTGGGAACGATACTCAGTTG
GGAAGTGTGCTGTCCCTATTTGTT -> GAAGTGTGCTGTCCCTATTTGTTG
TGACCGTACCGAAAGTCAAGAATG -> GACCGTACCGAAAGTCAAGAATGT
TTACTGATAGATAATGGTCTCAGA -> TACTGATAGATAATGGTCTCAGAC
CCGACGTGCCTATAAAATTACTGA -> CGACGTGCCTATAAAATTACTGAT
ATGTCCGAGGCACCCCGGATTCAA -> TGTCCGAGGCACCCCGGATTCAAT
ATCGAGCATTGAAATGCTAGGACG -> TCGAGCATTGAAATGCTAGGACGT
GGTGGTCACTCCTTATGTACCCAC -> GTGGTCACTCCTTATGTACCCACC
AGCGTAGAGGCCTCAACGTTCTGC -> GCGTAGAGGCCTCAACGTTCTGCC
AATGACCCCGCACCTGAAGCTATA -> ATGACCCCGCACCTGAAGCTATAC
TTGTTACCCGACGTGCCTATAAAA -> TGTTACCCGACGTGCCTATAAAAT
GAGCAGTTAATAGAAGTACCCCCT -> AGCAGTTAATAGAAGTACCCCCTC
AGGGGCACCGTTAAGTTTTTGTCG -> GGGGCACCGTTAAGTTTTTGTCGA
AGTGTGCTGTCCCTATTTGTTGTG -> GTGTGCTGTCCCTATTTGTTGTGA
GGTCTCAGACATATTGGACATTTC -> GTCTCAGACATATTGGACATTTCC
ATAGAAATGACCCCGCACCTGAAG -> TAGAAATGACCCCGCACCTGAAGC
TCTATGTACAAGTAACGGATGCTG -> CTATGTACAAGTAACGGATGCTGG
AGGCCGATCCGGAACTTACATGAA -> GGCCGATCCGGAACTTACATGAAT
TCTGTCCGGGTGGTCGCCGATGAC -> CTGTCCGGGTGGTCGCCGATGACT
AAAATAGCGGGAGATGAATAGGGG -> AAATAGCGGGAGATGAATAGGGGA
ATAGATAATGGTCTCAGACATATT -> TAGATAATGGTCTCAGACATATTG
CGATGCAACAACTGCTAACGAACG -> GATGCAACAACTGCTAACGAACGC
CATGACGGGTGCGGATGAAATATG -> ATGACGGGTGCGGATGAAATATGT
TATGCATGACGGGTGCGGATGAAA -> ATGCATGACGGGTGCGGATGAAAT
CAAATCGAGCATTGAAATGCTAGG -> AAATCGAGCATTGAAATGCTAGGA
CCCCCTCCTTCGTAGTGGGCGATG -> CCCCTCCTTCGTAGTGGGCGATGC
TCATCCCGATGGCCCTCACAAGAA -> CATCCCGATGGCCCTCACAAGAAC
TGAGGGTACCTCATCCCGATGGCC -> GAGGGTACCTCATCCCGATGGCCC
GATGAGGGTACCTCATCCCGATGG -> ATGAGGGTACCTCATCCCGATGGC
GGGCTCTGGATAGTGTATTTCAGG -> GGCTCTGGATAGTGTATTTCAGGC
ATGGCCAGCGATGCAACAACTGCT -> TGGCCAGCGATGCAACAACTGCTA
TAGTTCAATACATACGGGTGGTCA -> AGTTCAATACATACGGGTGGTCAC
GGTGCCCACTCCCCGCTTCAGATC -> GTGCCCACTCCCCGCTTCAGATCG
GGTAAATTAAAGGCTTCCCGAAGG -> GTAAATTAAAGGCTTCCCGAAGGG
CTCAGGAAATTTTTGTCTGTTCGA -> TCAGGAAATTTTTGTCTGTTCGAA
GGGGCACCGTTAAGTTTTTGTCGA -> GGGCACCGTTAAGTTTTTGTCGAT
AGGTTGCGGAGCGAGTCCTCTGTT -> GGTTGCGGAGCGAGTCCTCTGTTC
ATGCTAGGACGTCTATCAGGAAGT -> TGCTAGGACGTCTATCAGGAAGTG
ATTCAATAAAGCCCAGCTTGCCCT -> TTCAATAAAGCCCAGCTTGCCCTG
AAGAATGGAGGTTGCGGAGCGAGT -> AGAATGGAGGTTGCGGAGCGAGTC
GTTGTGTATGCATGACGGGTGCGG -> TTGTGTATGCATGACGGGTGCGGA
GGGAACCTCAGGAAATTTTTGTCT -> GGAACCTCAGGAAATTTTTGTCTG
CAGTTGAAAGCGTGCGTTGGGAAC -> AGTTGAAAGCGTGCGTTGGGAACG
CAGGAAGTGTGCTGTCCCTATTTG -> AGGAAGTGTGCTGTCCCTATTTGT
CCTCAACGTTCTGCCAGATCTTGA -> CTCAACGTTCTGCCAGATCTTGAT
GCCGATGACTTCGCCACCTAGTCA -> CCGATGACTTCGCCACCTAGTCAC
TGACATCTGAACAGTCGATATCCA -> GACATCTGAACAGTCGATATCCAT
TCACTTAGTCGACTGAGCGGGATA -> CACTTAGTCGACTGAGCGGGATAT
ACAGAACTTTGTTACCCGACGTGC -> CAGAACTTTGTTACCCGACGTGCC
TACATCGGAAAGATGAGGGTACCT -> ACATCGGAAAGATGAGGGTACCTC
GTGAAGAATGGAGGTTGCGGAGCG -> TGAAGAATGGAGGTTGCGGAGCGA
GGTGCGGATGAAATATGTCAGCAC -> GTGCGGATGAAATATGTCAGCACC
AGGCAGTCCGGTTGACAATGCATT -> GGCAGTCCGGTTGACAATGCATTT
AATAGGGGACAGTTGAAAGCGTGC -> ATAGGGGACAGTTGAAAGCGTGCG
TGATGCATAGAAATGACCCCGCAC -> GATGCATAGAAATGACCCCGCACC
AATCAGCGTAGAGGCCTCAACGTT -> ATCAGCGTAGAGGCCTCAACGTTC
GGTCGCCGATGACTTCGCCACCTA -> GTCGCCGATGACTTCGCCACCTAG
GGCGTATTAACTTGACTCAACCGG -> GCGTATTAACTTGACTCAACCGGA
GTATGGGTGAAGAATGGAGGTTGC -> TATGGGTGAAGAATGGAGGTTGCG
TTGCGGAGCGAGTCCTCTGTTCAT -> TGCGGAGCGAGTCCTCTGTTCATT
GTATTTCAGGCCGAGGTTGATTCC -> TATTTCAGGCCGAGGTTGATTCCC
CTAATAACTGCTCTTTACCTTGGT -> TAATAACTGCTCTTTACCTTGGTG
CTTTACCTTGGTGCCCACTCCCCG -> TTTACCTTGGTGCCCACTCCCCGC
TGCGGCTGAAACTGAATGGTAACG -> GCGGCTGAAACTGAATGGTAACGG
AGTACCCCCTCCTTCGTAGTGGGC -> GTACCCCCTCCTTCGTAGTGGGCG
CGTATTAACTTGACTCAACCGGAA -> GTATTAACTTGACTCAACCGGAAC
ATGCAACAACTGCTAACGAACGCT -> TGCAACAACTGCTAACGAACGCTT
GTTTGCCACACGAAACCGAAGTGG -> TTTGCCACACGAAACCGAAGTGGT
TACCGTGGGGCGTGACCGTACCGA -> ACCGTGGGGCGTGACCGTACCGAA
TCTGGATGGCACCTACGTACGAGA -> CTGGATGGCACCTACGTACGAGAC
TCATAAGCCATCAGAATCAGCGTA -> CATAAGCCATCAGAATCAGCGTAG
GACATTTCCTAATAACTGCTCTTT -> ACATTTCCTAATAACTGCTCTTTA
TACAGTTTACTTACCTCGACAGCT -> ACAGTTTACTTACCTCGACAGCTC
ACCGTTAAGTTTTTGTCGATAGTT -> CCGTTAAGTTTTTGTCGATAGTTG
GGGTGAAGAATGGAGGTTGCGGAG -> GGTGAAGAATGGAGGTTGCGGAGC
TGACTTCGCCACCTAGTCACCGGC -> GACTTCGCCACCTAGTCACCGGCA
GGAACGATACTCAGTTGGATGCGG -> GAACGATACTCAGTTGGATGCGGC
AAGCTATACAGGCGTATTAACTTG -> AGCTATACAGGCGTATTAACTTGA
GTTCGAAGCGACGCTCTTTTCGAG -> TTCGAAGCGACGCTCTTTTCGAGG
AGCGATGCAACAACTGCTAACGAA -> GCGATGCAACAACTGCTAACGAAC
TGTGAGCAGTTAATAGAAGTACCC -> GTGAGCAGTTAATAGAAGTACCCC
ACAGTTGAAAGCGTGCGTTGGGAA -> CAGTTGAAAGCGTGCGTTGGGAAC
ACAAGAACCGTTATCTGTCCGGGT -> CAAGAACCGTTATCTGTCCGGGTG
ACCCGACGTGCCTATAAAATTACT -> CCCGACGTGCCTATAAAATTACTG
ACCTTGGTGCCCACTCCCCGCTTC -> CCTTGGTGCCCACTCCCCGCTTCA
AGCTTGCCCTGTTTACTTCGTTCG -> GCTTGCCCTGTTTACTTCGTTCGG
CCGCCTCAATCCTTACTGATGTCC -> CGCCTCAATCCTTACTGATGTCCA
CTTTTCGAGGGGCACCGTTAAGTT -> TTTTCGAGGGGCACCGTTAAGTTT
GATGAATAGGGGACAGTTGAAAGC -> ATGAATAGGGGACAGTTGAAAGCG
GCAGCTACAGTTTACTTACCTCGA -> CAGCTACAGTTTACTTACCTCGAC
GCGTAGGCGCGAGCGGAGACTGCC -> CGTAGGCGCGAGCGGAGACTGCCG
AGGCGTTACGTTCAGAGGCCGATC -> GGCGTTACGTTCAGAGGCCGATCC
TAAGTTTTTGTCGATAGTTGTTTC -> AAGTTTTTGTCGATAGTTGTTTCC
ACGAACGCTTACCAACTCAATCTA -> CGAACGCTTACCAACTCAATCTAG
TGCGGAGCGAGTCCTCTGTTCATT -> GCGGAGCGAGTCCTCTGTTCATTC
TGCTAACGAACGCTTACCAACTCA -> GCTAACGAACGCTTACCAACTCAA
AGCGTTGTGTATGCATGACGGGTG -> GCGTTGTGTATGCATGACGGGTGC
GGTACCTCATCCCGATGGCCCTCA -> GTACCTCATCCCGATGGCCCTCAC
TCGGAAAGATGAGGGTACCTCATC -> CGGAAAGATGAGGGTACCTCATCC
AATAACTGCTCTTTACCTTGGTGC -> ATAACTGCTCTTTACCTTGGTGCC
AGGTACAGAACTTTGTTACCCGAC -> GGTACAGAACTTTGTTACCCGACG
CCCAGCTTGCCCTGTTTACTTCGT -> CCAGCTTGCCCTGTTTACTTCGTT
CTTGGTGCCCACTCCCCGCTTCAG -> TTGGTGCCCACTCCCCGCTTCAGA
CTACCGGGGTATGGGTGAAGAATG -> TACCGGGGTATGGGTGAAGAATGG
GTGCGGATGAAATATGTCAGCACC -> TGCGGATGAAATATGTCAGCACCG
AATTCAGCGTTGTGTATGCATGAC -> ATTCAGCGTTGTGTATGCATGACG
TTACTGATGTCCATGTCCGAGGCA -> TACTGATGTCCATGTCCGAGGCAC
TGCATCTCGGTATGAACCTCCCCT -> GCATCTCGGTATGAACCTCCCCTC
ATATTGGACATTTCCTAATAACTG -> TATTGGACATTTCCTAATAACTGC
GTTGAAAGCGTGCGTTGGGAACGA -> TTGAAAGCGTGCGTTGGGAACGAT
GTTAATGCATGGAATAAAAAAAAA -> TTAATGCATGGAATAAAAAAAAAT
CGGGGTATGGGTGAAGAATGGAGG -> GGGGTATGGGTGAAGAATGGAGGT
CTACAGTTTACTTACCTCGACAGC -> TACAGTTTACTTACCTCGACAGCT
TTTACTTACCTCGACAGCTCGGGG -> TTACTTACCTCGACAGCTCGGGGC
ACAATGCATTTGATCGTCATAAGC -> CAATGCATTTGATCGTCATAAGCC
GATGTCCATGTCCGAGGCACCCCG -> ATGTCCATGTCCGAGGCACCCCGG
TGCCTATAAAATTACTGATAGATA -> GCCTATAAAATTACTGATAGATAA
TCATCTTGAATCCTATTTAGTTCA -> CATCTTGAATCCTATTTAGTTCAA
ACTCCCCGCTTCAGATCGCCTCAC -> CTCCCCGCTTCAGATCGCCTCACT
GGGCAAGTGGCATAATACCGCACA -> GGCAAGTGGCATAATACCGCACAA
AGGCACCCCGGATTCAATAAAGCC -> GGCACCCCGGATTCAATAAAGCCC
GTGTGCTGTCCCTATTTGTTGTGA -> TGTGCTGTCCCTATTTGTTGTGAC
GGCCTCAACGTTCTGCCAGATCTT -> GCCTCAACGTTCTGCCAGATCTTG
TGGCCGCCTACCGGGGTATGGGTG -> GGCCGCCTACCGGGGTATGGGTGA
ACTTGACTCAACCGGAACCAGACT -> CTTGACTCAACCGGAACCAGACTG
TCAGGAAGTGTGCTGTCCCTATTT -> CAGGAAGTGTGCTGTCCCTATTTG
GCGGAGACTGCCGGAACTCGTTCC -> CGGAGACTGCCGGAACTCGTTCCG
ACGGGGACTACGTCACGTAGTCAC -> CGGGGACTACGTCACGTAGTCACT
GTAGTGGGCGATGCTATGTGATTG -> TAGTGGGCGATGCTATGTGATTGT
GGAATAAAAAAAAATAGCGGGAGA -> GAATAAAAAAAAATAGCGGGAGAT
ACTCGTTCCGATCTCTTAAGGTGC -> CTCGTTCCGATCTCTTAAGGTGCG
TGTCAGCACCGCGTAGGCGCGAGC -> GTCAGCACCGCGTAGGCGCGAGCG
CGATACTCAGTTGGATGCGGCTGA -> GATACTCAGTTGGATGCGGCTGAA
AACTCTATGTACAAGTAACGGATG -> ACTCTATGTACAAGTAACGGATGC
AAACGGCTACGGTATAGTGCTCGG -> AACGGCTACGGTATAGTGCTCGGA
CAACGTTCTGCCAGATCTTGATGC -> AACGTTCTGCCAGATCTTGATGCA
AAGCCCAGCTTGCCCTGTTTACTT -> AGCCCAGCTTGCCCTGTTTACTTC
GGGCGTGACCGTACCGAAAGTCAA -> GGCGTGACCGTACCGAAAGTCAAG
GCATTTGATCGTCATAAGCCATCA -> CATTTGATCGTCATAAGCCATCAG
ATAAGCCGCCTCAATCCTTACTGA -> TAAGCCGCCTCAATCCTTACTGAT
TTTTTGTCTGTTCGAAGCGACGCT -> TTTTGTCTGTTCGAAGCGACGCTC
CTGACATCTGAACAGTCGATATCC -> TGACATCTGAACAGTCGATATCCA
GCAGGATGAGGTTTGCCACACGAA -> CAGGATGAGGTTTGCCACACGAAA
AGCGGGATATAGTACCGTGGGGCG -> GCGGGATATAGTACCGTGGGGCGT
ACCCCGCACCTGAAGCTATACAGG -> CCCCGCACCTGAAGCTATACAGGC
GTATGAACCTCCCCTCATAAGCCG -> TATGAACCTCCCCTCATAAGCCGC
GTCTCAGACATATTGGACATTTCC -> TCTCAGACATATTGGACATTTCCT
TAGTACCGTGGGGCGTGACCGTAC -> AGTACCGTGGGGCGTGACCGTACC
CCGGAACTTACATGAATTCGCGAT -> CGGAACTTACATGAATTCGCGATA
CCGATGACTTCGCCACCTAGTCAC -> CGATGACTTCGCCACCTAGTCACC
TACCCACCTTGGTGCGCACAAACG -> ACCCACCTTGGTGCGCACAAACGG
CCCTCATAAGCCGCCTCAATCCTT -> CCTCATAAGCCGCCTCAATCCTTA
TTAACTTGACTCAACCGGAACCAG -> TAACTTGACTCAACCGGAACCAGA
ATCTGGATGGCACCTACGTACGAG -> TCTGGATGGCACCTACGTACGAGA
TTGACTCAACCGGAACCAGACTGG -> TGACTCAACCGGAACCAGACTGGT
CTGACTCATCTTGAATCCTATTTA -> TGACTCATCTTGAATCCTATTTAG
TCCGATCTCTTAAGGTGCGACGGG -> CCGATCTCTTAAGGTGCGACGGGG
ATGTAATGGCCTGCGTCAGAGGCA -> TGTAATGGCCTGCGTCAGAGGCAG
TCAATCTAGGCGTTACGTTCAGAG -> CAATCTAGGCGTTACGTTCAGAGG
ATGCTGGCCGCCTACCGGGGTATG -> TGCTGGCCGCCTACCGGGGTATGG
GGCTACGGTATAGTGCTCGGAACT -> GCTACGGTATAGTGCTCGGAACTC
GTGCCTATAAAATTACTGATAGAT -> TGCCTATAAAATTACTGATAGATA
CCTCCCCTCATAAGCCGCCTCAAT -> CTCCCCTCATAAGCCGCCTCAATC
CGAGCGGAGACTGCCGGAACTCGT -> GAGCGGAGACTGCCGGAACTCGTT
AGTAACGGATGCTGGCCGCCTACC -> GTAACGGATGCTGGCCGCCTACCG
TGAATGGTAACGGCTGACATCTGA -> GAATGGTAACGGCTGACATCTGAA
GTAGAGGCCTCAACGTTCTGCCAG -> TAGAGGCCTCAACGTTCTGCCAGA
AGATCTTGATGCATAGAAATGACC -> GATCTTGATGCATAGAAATGACCC
ACCAGACTGGTACATCGGAAAGAT -> CCAGACTGGTACATCGGAAAGATG
ATATCCATCTGGATGGCACCTACG -> TATCCATCTGGATGGCACCTACGT
CTGTCCCTATTTGTTGTGACACAG -> TGTCCCTATTTGTTGTGACACAGG
GTACGAGACGCTGCCCTGCGCTCT -> TACGAGACGCTGCCCTGCGCTCTC
TAGGCGCGAGCGGAGACTGCCGGA -> AGGCGCGAGCGGAGACTGCCGGAA
TTGTCTGTTCGAAGCGACGCTCTT -> TGTCTGTTCGAAGCGACGCTCTTT
GTCAGCGATCAATGTTAATGCATG -> TCAGCGATCAATGTTAATGCATGG
TACCGCACAATCTTATAATAGTCG -> ACCGCACAATCTTATAATAGTCGC
ACTTACCTCGACAGCTCGGGGCAA -> CTTACCTCGACAGCTCGGGGCAAG
ATCTGAACAGTCGATATCCATCTG -> TCTGAACAGTCGATATCCATCTGG
GCGGCTGAAACTGAATGGTAACGG -> CGGCTGAAACTGAATGGTAACGGC
GACAGCTCGGGGCAAGTGGCATAA -> ACAGCTCGGGGCAAGTGGCATAAT
CGGAACTTACATGAATTCGCGATA -> GGAACTTACATGAATTCGCGATAA
TGATGTCCATGTCCGAGGCACCCC -> GATGTCCATGTCCGAGGCACCCCG
ATTTCCTAATAACTGCTCTTTACC -> TTTCCTAATAACTGCTCTTTACCT
TTATGTACCCACCTTGGTGCGCAC -> TATGTACCCACCTTGGTGCGCACA
AAGCAGCCAGATGCATCTCGGTAT -> AGCAGCCAGATGCATCTCGGTATG
CAGAATCAGCGTAGAGGCCTCAAC -> AGAATCAGCGTAGAGGCCTCAACG
AAGAATGTAATGGCCTGCGTCAGA -> AGAATGTAATGGCCTGCGTCAGAG
GGGGCGTGACCGTACCGAAAGTCA -> GGGCGTGACCGTACCGAAAGTCAA
GAATGTAATGGCCTGCGTCAGAGG -> AATGTAATGGCCTGCGTCAGAGGC
GCGTGACCGTACCGAAAGTCAAGA -> CGTGACCGTACCGAAAGTCAAGAA
TAGTGGGCGATGCTATGTGATTGT -> AGTGGGCGATGCTATGTGATTGTC
CCCGCTTCAGATCGCCTCACTTAG -> CCGCTTCAGATCGCCTCACTTAGT
TCCGGGTGGTCGCCGATGACTTCG -> CCGGGTGGTCGCCGATGACTTCGC
CGCAAGGCAGCTACAGTTTACTTA -> GCAAGGCAGCTACAGTTTACTTAC
GTATAGTGCTCGGAACTCTATGTA -> TATAGTGCTCGGAACTCTATGTAC
GACTCAACCGGAACCAGACTGGTA -> ACTCAACCGGAACCAGACTGGTAC
CCACTCCCCGCTTCAGATCGCCTC -> CACTCCCCGCTTCAGATCGCCTCA
CCGAGGCACCCCGGATTCAATAAA -> CGAGGCACCCCGGATTCAATAAAG
CGAGGCACCCCGGATTCAATAAAG -> GAGGCACCCCGGATTCAATAAAGC
TTTCCGCAAGGCAGCTACAGTTTA -> TTCCGCAAGGCAGCTACAGTTTAC
TCAGGAAATTTTTGTCTGTTCGAA -> CAGGAAATTTTTGTCTGTTCGAAG
GGACGTCTATCAGGAAGTGTGCTG -> GACGTCTATCAGGAAGTGTGCTGT
TCAAGAATGTAATGGCCTGCGTCA -> CAAGAATGTAATGGCCTGCGTCAG
GATAGTTGTTTCCGCAAGGCAGCT -> ATAGTTGTTTCCGCAAGGCAGCTA
TATCAGGAAGTGTGCTGTCCCTAT -> ATCAGGAAGTGTGCTGTCCCTATT
TGAAAGCGTGCGTTGGGAACGATA -> GAAAGCGTGCGTTGGGAACGATAC
GATGCTGGCCGCCTACCGGGGTAT -> ATGCTGGCCGCCTACCGGGGTATG
AATAAAGCCCAGCTTGCCCTGTTT -> ATAAAGCCCAGCTTGCCCTGTTTA
CGCCTCAATCCTTACTGATGTCCA -> GCCTCAATCCTTACTGATGTCCAT
CTTCGTAGTGGGCGATGCTATGTG -> TTCGTAGTGGGCGATGCTATGTGA
ATGTCCATGTCCGAGGCACCCCGG -> TGTCCATGTCCGAGGCACCCCGGA
CTCAATCCTTACTGATGTCCATGT -> TCAATCCTTACTGATGTCCATGTC
CCTTACTGATGTCCATGTCCGAGG -> CTTACTGATGTCCATGTCCGAGGC
TCATCAATTCAGCGTTGTGTATGC -> CATCAATTCAGCGTTGTGTATGCA
CAGCACCGCGTAGGCGCGAGCGGA -> AGCACCGCGTAGGCGCGAGCGGAG
CTATGTACAAGTAACGGATGCTGG -> TATGTACAAGTAACGGATGCTGGC
TAACGGCTGACATCTGAACAGTCG -> AACGGCTGACATCTGAACAGTCGA
CATTTGATCGTCATAAGCCATCAG -> ATTTGATCGTCATAAGCCATCAGA
GCGCACAAACGGCTACGGTATAGT -> CGCACAAACGGCTACGGTATAGTG
GTGTATTTCAGGCCGAGGTTGATT -> TGTATTTCAGGCCGAGGTTGATTC
AATGGTCTCAGACATATTGGACAT -> ATGGTCTCAGACATATTGGACATT
TTAGTCGACTGAGCGGGATATAGT -> TAGTCGACTGAGCGGGATATAGTA
TCCGAGGCACCCCGGATTCAATAA -> CCGAGGCACCCCGGATTCAATAAA
TACCTCGACAGCTCGGGGCAAGTG -> ACCTCGACAGCTCGGGGCAAGTGG
TTTGCCACACGAAACCGAAGTGGT -> TTGCCACACGAAACCGAAGTGGTA
TTGATTCCCCCGGACGGTAACCGA -> TGATTCCCCCGGACGGTAACCGAT
GCCGATCCGGAACTTACATGAATT -> CCGATCCGGAACTTACATGAATTC
ATGCATGGAATAAAAAAAAATAGC -> TGCATGGAATAAAAAAAAATAGCG
GTTACGTTCAGAGGCCGATCCGGA -> TTACGTTCAGAGGCCGATCCGGAA
CTCACTTAGTCGACTGAGCGGGAT -> TCACTTAGTCGACTGAGCGGGATA
